Input	Predicted	True
<s></s></s> 知道。</s>	neutral	neutral
<s> 知道。 </s></s> 那裏有你認識的人嗎?</s>	surprise	surprise
<s></s></s> 有。</s>	neutral	neutral
<s> 有。 </s></s> 認識誰?</s>	surprise	surprise
<s></s></s> 他們的廠長苗鳳山。</s>	neutral	neutral
<s> 他們的廠長苗鳳山。 </s></s> 你們有來往嗎,在經濟方面?</s>	surprise	surprise
<s></s></s> 有,我買過他們的機器,印刷機。</s>	joy	neutral
<s> 有,我買過他們的機器,印刷機。 </s></s> 給錢了嗎?</s>	surprise	surprise
<s></s></s> 給了。</s>	neutral	neutral
<s> 給了。 </s></s> 給了多少錢?</s>	surprise	surprise
<s></s></s> 八十六萬。</s>	neutral	neutral
<s> 八十六萬。 </s></s> 此外還有別的錢嗎?</s>	surprise	surprise
<s></s></s> 還有點餘款在他那裏。</s>	neutral	neutral
<s> 還有點餘款在他那裏。 </s></s> 多少餘款?</s>	surprise	surprise
<s></s></s> 十四萬。</s>	neutral	neutral
<s> 十四萬。 </s></s> 這就對了。苗鳳山涉嫌販賣毒品,牽涉到你,所以請你來說清楚。</s>	neutral	neutral
<s></s></s> 你們放心!我沒作違法的事!</s>	joy	fear
<s> 你們放心!我沒作違法的事! </s></s> 咱們怎麼辦?</s>	fear	fear
<s></s></s> 走!快去找!</s>	surprise	surprise
<s> 走!快去找! </s></s> 找派出所?</s>	surprise	surprise
<s></s></s> 找派出所有啥用?找爸!</s>	angry	surprise
<s> 找派出所有啥用?找爸! </s></s> 馬總?</s>	surprise	surprise
<s></s></s> 爸!</s>	surprise	surprise
<s> 爸! </s></s> 小花!</s>	joy	surprise
<s></s></s> 爸!小軍給公安局抓走了!</s>	surprise	fear
<s> 爸!小軍給公安局抓走了! </s></s> 什麼!你說什麼?</s>	surprise	surprise
<s></s></s> 小軍讓公安局抓走了!</s>	angry	fear
<s> 小軍讓公安局抓走了! </s></s> 小花別哭,別怕。你說什麼?小軍讓公安局抓走了?什麼時候?</s>	fear	surprise
<s></s></s> 就今天上午,在青河!</s>	joy	sadness
<s> 就今天上午,在青河! </s></s> 爲什麼抓他?</s>	surprise	surprise
<s></s></s> 他們說他跟一個販毒的案件有關。</s>	neutral	sadness
<s> 他們說他跟一個販毒的案件有關。 </s></s> 販毒的案件?</s>	surprise	surprise
<s></s></s> 也沒詳細說什麼案件,就讓跟他們去說清楚。</s>	neutral	sadness
<s> 也沒詳細說什麼案件,就讓跟他們去說清楚。 </s></s> 馬軍沒說話嗎?</s>	surprise	fear
<s></s></s> 他說他沒做犯法的事,讓我們放心。</s>	joy	fear
<s> 他說他沒做犯法的事,讓我們放心。 </s></s> 噢,都有誰在跟前?</s>	surprise	surprise
<s></s></s> 就我和白鴿。</s>	joy	fear
<s> 就我和白鴿。 </s></s> 白鴿呢?</s>	surprise	surprise
<s></s></s> 回家了,她說找他爸去。</s>	neutral	fear
<s> 回家了,她說找他爸去。 </s></s> 你們爲什麼纔回來?</s>	surprise	surprise
<s></s></s> 等小火車。</s>	neutral	fear
<s> 等小火車。 </s></s> 放心吧孩子,相信馬軍。他說他沒做犯法的事那就沒事。你先回家,我去問一下。這事先不要跟小姨說,尤其不要讓爺爺知道,他會着急的,啊!</s>	joy	fear
<s></s></s> 爸,您要上班?</s>	surprise	surprise
<s> 爸,您要上班? </s></s> 是呀,你怎麼這時候回來?</s>	surprise	surprise
<s></s></s> 有事!爸,您先別走,我有事跟您說。</s>	neutral	surprise
<s> 有事!爸,您先別走,我有事跟您說。 </s></s> 啥事,這麼急?</s>	surprise	surprise
<s></s></s> 爸,您跟派出所的人熟不熟呀?</s>	surprise	fear
<s> 爸,您跟派出所的人熟不熟呀? </s></s> 景陽鎮就這麼大個地方,還有誰不熟呀?</s>	surprise	neutral
<s></s></s> 我是說您能跟他們說上話嗎?</s>	fear	fear
<s> 我是說您能跟他們說上話嗎? </s></s> 說什麼話?</s>	surprise	surprise
<s></s></s> 說好話,求情的話。</s>	neutral	fear
<s> 說好話,求情的話。 </s></s> “說什麼好話?給誰求情?</s>	angry	surprise
<s></s></s> 馬軍叫派出所的人給帶走了?</s>	surprise	sadness
<s> 馬軍叫派出所的人給帶走了? </s></s> 派出所給帶走了?爲什麼?</s>	surprise	surprise
<s></s></s> 說是哈爾濱的一個什麼案子跟他有關係。</s>	neutral	sadness
<s> 說是哈爾濱的一個什麼案子跟他有關係。 </s></s> 哈爾濱的案子跟他有什麼關係?</s>	surprise	surprise
<s></s></s> 他不是在哈爾濱買了兩臺印刷機嗎?</s>	surprise	sadness
<s> 他不是在哈爾濱買了兩臺印刷機嗎? </s></s> 聽說了,怎麼了?</s>	surprise	surprise
<s></s></s> 賣給他印刷機的那個人犯案了。</s>	angry	sadness
<s> 賣給他印刷機的那個人犯案了。 </s></s> 犯什麼案了?</s>	surprise	surprise
<s></s></s> 說是什麼毒品案。</s>	neutral	sadness
<s> 說是什麼毒品案。 </s></s> 毒品案?</s>	surprise	surprise
<s></s></s> 當時也沒詳細說,就說那個人涉嫌販毒,跟馬軍有點關係,讓他去說清楚。</s>	neutral	fear
<s> 當時也沒詳細說,就說那個人涉嫌販毒,跟馬軍有點關係,讓他去說清楚。 </s></s> 馬軍沒說啥嗎?</s>	surprise	surprise
<s></s></s> 他說他沒做犯法的事,讓我們放心。</s>	joy	fear
<s> 他說他沒做犯法的事,讓我們放心。 </s></s> 那你們放不放心?相不相信馬軍?</s>	fear	surprise
<s></s></s> 馬軍我們當然相信。</s>	joy	sadness
<s> 馬軍我們當然相信。 </s></s> 那不得了,還求什麼情呀?</s>	sadness	surprise
<s></s></s> 可是萬一他......</s>	fear	fear
<s> 可是萬一他...... </s></s> 沒什麼萬一。馬軍那麼機靈的孩子會幹那種事?有時候可能自己覺察不到做錯了什麼事,不是有意去做的,說清楚就行了唄。馬軍的事他自己會說清楚的。</s>	neutral	neutral
<s></s></s> 你不用上派出所去?</s>	surprise	surprise
<s> 你不用上派出所去? </s></s> 不用!再說了,馬軍要是真有事,誰去說也沒有用!</s>	angry	neutral
<s></s></s> 我都跟曉華說好了,我倆一塊回家來跟爸說。</s>	neutral	sadness
<s> 我都跟曉華說好了,我倆一塊回家來跟爸說。 </s></s> 曉華回家跟他爸說了?跟馬總?</s>	surprise	surprise
<s></s></s> 她肯定說了。</s>	neutral	sadness
<s> 她肯定說了。 </s></s> 那就行了,馬總會把一切事情都辦妥的,咱們不用管了。</s>	neutral	joy
<s></s></s> 姓名?</s>	surprise	neutral
<s> 姓名? </s></s> 苗鳳山。</s>	neutral	neutral
<s></s></s> 年齡?</s>	surprise	neutral
<s> 年齡? </s></s> 四十二。</s>	neutral	neutral
<s></s></s> 職業?</s>	surprise	neutral
<s> 職業? </s></s> 個體工商戶。</s>	neutral	neutral
<s></s></s> 行業?</s>	surprise	neutral
<s> 行業? </s></s> 印刷,廣告。</s>	neutral	neutral
<s></s></s> 你最近有一筆投資,是嗎?</s>	surprise	neutral
<s> 你最近有一筆投資,是嗎? </s></s> 是。</s>	neutral	neutral
<s></s></s> 多少錢?</s>	surprise	neutral
<s> 多少錢? </s></s> 三十萬。</s>	neutral	neutral
<s></s></s> 投給誰的?</s>	surprise	neutral
<s> 投給誰的? </s></s> 龍江投資諮詢公司。</s>	neutral	neutral
<s></s></s> 你怎麼知道這個公司?</s>	surprise	surprise
<s> 你怎麼知道這個公司? </s></s> 他在我這裏作過廣告。</s>	neutral	neutral
<s></s></s> 在你的小報上作廣告的不少吧?你爲什麼要給他投資?</s>	surprise	surprise
<s> 在你的小報上作廣告的不少吧?你爲什麼要給他投資? </s></s> 他給的利息高。</s>	neutral	neutral
<s></s></s> 利息是多少?</s>	neutral	surprise
<s> 利息是多少? </s></s> 月息是百分之一。</s>	neutral	neutral
<s></s></s> 能兌現嗎?</s>	surprise	surprise
<s> 能兌現嗎? </s></s> 兌現了。</s>	joy	neutral
<s></s></s> 投了幾次?</s>	surprise	neutral
<s> 投了幾次? </s></s> 就投了這一次。</s>	joy	neutral
<s></s></s> 他們給了你多少利息?</s>	surprise	neutral
<s> 他們給了你多少利息? </s></s> 三千塊錢。</s>	neutral	neutral
<s></s></s> 你知道他們是經營什麼的嗎?</s>	surprise	neutral
<s> 你知道他們是經營什麼的嗎? </s></s> 不知道。</s>	neutral	neutral
<s></s></s> 這個所謂的投資諮詢公司,實際上是一個販毒團伙。他們以集資的方式籌集資金販賣毒品,以高利率吸引投資,給你的利息正是他們販毒掙來的錢。</s>	neutral	disgust
<s> 這個所謂的投資諮詢公司,實際上是一個販毒團伙。他們以集資的方式籌集資金販賣毒品,以高利率吸引投資,給你的利息正是他們販毒掙來的錢。 </s></s> 我根本不知道他們吸收存款是去販毒呀!</s>	surprise	fear
<s></s></s> 那是,你要知道他們販毒就不會給他們投資了。可是你不知道不等於你沒做呀。</s>	sadness	neutral
<s> 那是,你要知道他們販毒就不會給他們投資了。可是你不知道不等於你沒做呀。 </s></s> 還有,那三十萬塊錢,主要也不是我的錢。我自己的只有六萬,其餘二十四萬不是我的。</s>	sadness	fear
<s></s></s> 那是誰的錢?</s>	angry	surprise
<s> 那是誰的錢? </s></s> 是馬軍的。</s>	neutral	neutral
<s></s></s> 馬軍是誰?</s>	surprise	surprise
<s> 馬軍是誰? </s></s> 馬軍是景陽林業局印刷廠的廠長。</s>	neutral	neutral
<s></s></s> 他的錢怎麼會在你這裏?</s>	surprise	surprise
<s> 他的錢怎麼會在你這裏? </s></s> 他給了我一百萬塊錢,在我這裏買了兩臺印刷機,花了七十六萬,剩下的二十四萬他沒拿回去,說放在我這裏,讓我給他投資掙點錢。我準備給他買股票,後來一看投資掙錢多,就給這個公司投進去了。</s>	neutral	fear
<s></s></s> 你給這個公司投資,事先跟他說了嗎?</s>	surprise	neutral
<s> 你給這個公司投資,事先跟他說了嗎? </s></s> 說了。</s>	neutral	neutral
<s></s></s> 他同意嗎?</s>	surprise	surprise
<s> 他同意嗎? </s></s> 同意。</s>	joy	neutral
<s></s></s> 你怎麼跟他說的?他來了嗎?</s>	surprise	surprise
<s> 你怎麼跟他說的?他來了嗎? </s></s> 他沒來,在電話上說的。</s>	neutral	neutral
<s></s></s> 馬總來了!我正準備向你彙報呢。</s>	neutral	surprise
<s> 馬總來了!我正準備向你彙報呢。 </s></s> 到底怎麼回事?孩子光害怕也說不清楚。</s>	fear	fear
<s> 馬總來了!我正準備向你彙報呢。 到底怎麼回事?孩子光害怕也說不清楚。 </s></s> 是這樣的。從哈爾濱道外區公安分局來了兩個警員,說他們那裏有個印刷廠,叫前進印刷廠。這個廠的廠長苗鳳山涉嫌販毒被警方拘留了。據苗鳳山交代,他提供的毒資當中有馬軍的錢。所以他們來把馬軍帶過去詢問一下,看是什麼情況。</s>	neutral	fear
<s> 馬總來了!我正準備向你彙報呢。 到底怎麼回事?孩子光害怕也說不清楚。 是這樣的。從哈爾濱道外區公安分局來了兩個警員,說他們那裏有個印刷廠,叫前進印刷廠。這個廠的廠長苗鳳山涉嫌販毒被警方拘留了。據苗鳳山交代,他提供的毒資當中有馬軍的錢。所以他們來把馬軍帶過去詢問一下,看是什麼情況。 </s></s> 他們說有馬軍的錢是多少錢?</s>	surprise	surprise
<s> 馬總來了!我正準備向你彙報呢。 到底怎麼回事?孩子光害怕也說不清楚。 是這樣的。從哈爾濱道外區公安分局來了兩個警員,說他們那裏有個印刷廠,叫前進印刷廠。這個廠的廠長苗鳳山涉嫌販毒被警方拘留了。據苗鳳山交代,他提供的毒資當中有馬軍的錢。所以他們來把馬軍帶過去詢問一下,看是什麼情況。 他們說有馬軍的錢是多少錢? </s></s> 說有二十多萬呢!</s>	neutral	fear
<s> 馬總來了!我正準備向你彙報呢。 到底怎麼回事?孩子光害怕也說不清楚。 是這樣的。從哈爾濱道外區公安分局來了兩個警員,說他們那裏有個印刷廠,叫前進印刷廠。這個廠的廠長苗鳳山涉嫌販毒被警方拘留了。據苗鳳山交代,他提供的毒資當中有馬軍的錢。所以他們來把馬軍帶過去詢問一下,看是什麼情況。 他們說有馬軍的錢是多少錢? 說有二十多萬呢! </s></s> 二十多萬?</s>	surprise	surprise
<s> 馬總來了!我正準備向你彙報呢。 到底怎麼回事?孩子光害怕也說不清楚。 是這樣的。從哈爾濱道外區公安分局來了兩個警員,說他們那裏有個印刷廠,叫前進印刷廠。這個廠的廠長苗鳳山涉嫌販毒被警方拘留了。據苗鳳山交代,他提供的毒資當中有馬軍的錢。所以他們來把馬軍帶過去詢問一下,看是什麼情況。 他們說有馬軍的錢是多少錢? 說有二十多萬呢! 二十多萬? </s></s> 是呀!我也納悶,馬軍怎麼會有那麼多錢?</s>	surprise	surprise
<s> 馬總來了!我正準備向你彙報呢。 到底怎麼回事?孩子光害怕也說不清楚。 是這樣的。從哈爾濱道外區公安分局來了兩個警員,說他們那裏有個印刷廠,叫前進印刷廠。這個廠的廠長苗鳳山涉嫌販毒被警方拘留了。據苗鳳山交代,他提供的毒資當中有馬軍的錢。所以他們來把馬軍帶過去詢問一下,看是什麼情況。 他們說有馬軍的錢是多少錢? 說有二十多萬呢! 二十多萬? 是呀!我也納悶,馬軍怎麼會有那麼多錢? </s></s> 據我瞭解,那不是馬軍的錢,那是咱們林業局的錢,是公款。</s>	neutral	fear
<s> 馬總來了!我正準備向你彙報呢。 到底怎麼回事?孩子光害怕也說不清楚。 是這樣的。從哈爾濱道外區公安分局來了兩個警員,說他們那裏有個印刷廠,叫前進印刷廠。這個廠的廠長苗鳳山涉嫌販毒被警方拘留了。據苗鳳山交代,他提供的毒資當中有馬軍的錢。所以他們來把馬軍帶過去詢問一下,看是什麼情況。 他們說有馬軍的錢是多少錢? 說有二十多萬呢! 二十多萬? 是呀!我也納悶,馬軍怎麼會有那麼多錢? 據我瞭解,那不是馬軍的錢,那是咱們林業局的錢,是公款。 </s></s> 公款怎麼弄到哈爾濱去了?</s>	surprise	surprise
<s> 馬總來了!我正準備向你彙報呢。 到底怎麼回事?孩子光害怕也說不清楚。 是這樣的。從哈爾濱道外區公安分局來了兩個警員,說他們那裏有個印刷廠,叫前進印刷廠。這個廠的廠長苗鳳山涉嫌販毒被警方拘留了。據苗鳳山交代,他提供的毒資當中有馬軍的錢。所以他們來把馬軍帶過去詢問一下,看是什麼情況。 他們說有馬軍的錢是多少錢? 說有二十多萬呢! 二十多萬? 是呀!我也納悶,馬軍怎麼會有那麼多錢? 據我瞭解,那不是馬軍的錢,那是咱們林業局的錢,是公款。 公款怎麼弄到哈爾濱去了? </s></s> 節前馬軍在哈爾濱買了兩臺印刷機,給人家匯去了一百萬塊錢,買機器花了八十六萬,還剩下十四萬在他們那邊沒給匯回來,可能就是這個錢。</s>	neutral	angry
<s> 馬總來了!我正準備向你彙報呢。 到底怎麼回事?孩子光害怕也說不清楚。 是這樣的。從哈爾濱道外區公安分局來了兩個警員,說他們那裏有個印刷廠,叫前進印刷廠。這個廠的廠長苗鳳山涉嫌販毒被警方拘留了。據苗鳳山交代,他提供的毒資當中有馬軍的錢。所以他們來把馬軍帶過去詢問一下,看是什麼情況。 他們說有馬軍的錢是多少錢? 說有二十多萬呢! 二十多萬? 是呀!我也納悶,馬軍怎麼會有那麼多錢? 據我瞭解,那不是馬軍的錢,那是咱們林業局的錢,是公款。 公款怎麼弄到哈爾濱去了? 節前馬軍在哈爾濱買了兩臺印刷機,給人家匯去了一百萬塊錢,買機器花了八十六萬,還剩下十四萬在他們那邊沒給匯回來,可能就是這個錢。 </s></s> 讓他們給動用了?</s>	surprise	surprise
<s> 到底怎麼回事?孩子光害怕也說不清楚。 是這樣的。從哈爾濱道外區公安分局來了兩個警員,說他們那裏有個印刷廠,叫前進印刷廠。這個廠的廠長苗鳳山涉嫌販毒被警方拘留了。據苗鳳山交代,他提供的毒資當中有馬軍的錢。所以他們來把馬軍帶過去詢問一下,看是什麼情況。 他們說有馬軍的錢是多少錢? 說有二十多萬呢! 二十多萬? 是呀!我也納悶,馬軍怎麼會有那麼多錢? 據我瞭解,那不是馬軍的錢,那是咱們林業局的錢,是公款。 公款怎麼弄到哈爾濱去了? 節前馬軍在哈爾濱買了兩臺印刷機,給人家匯去了一百萬塊錢,買機器花了八十六萬,還剩下十四萬在他們那邊沒給匯回來,可能就是這個錢。 讓他們給動用了? </s></s> 那肯定唄。</s>	joy	angry
<s> 是這樣的。從哈爾濱道外區公安分局來了兩個警員,說他們那裏有個印刷廠,叫前進印刷廠。這個廠的廠長苗鳳山涉嫌販毒被警方拘留了。據苗鳳山交代,他提供的毒資當中有馬軍的錢。所以他們來把馬軍帶過去詢問一下,看是什麼情況。 他們說有馬軍的錢是多少錢? 說有二十多萬呢! 二十多萬? 是呀!我也納悶,馬軍怎麼會有那麼多錢? 據我瞭解,那不是馬軍的錢,那是咱們林業局的錢,是公款。 公款怎麼弄到哈爾濱去了? 節前馬軍在哈爾濱買了兩臺印刷機,給人家匯去了一百萬塊錢,買機器花了八十六萬,還剩下十四萬在他們那邊沒給匯回來,可能就是這個錢。 讓他們給動用了? 那肯定唄。 </s></s> 他們怎麼說有二十多萬呢?</s>	surprise	surprise
<s> 他們說有馬軍的錢是多少錢? 說有二十多萬呢! 二十多萬? 是呀!我也納悶,馬軍怎麼會有那麼多錢? 據我瞭解,那不是馬軍的錢,那是咱們林業局的錢,是公款。 公款怎麼弄到哈爾濱去了? 節前馬軍在哈爾濱買了兩臺印刷機,給人家匯去了一百萬塊錢,買機器花了八十六萬,還剩下十四萬在他們那邊沒給匯回來,可能就是這個錢。 讓他們給動用了? 那肯定唄。 他們怎麼說有二十多萬呢? </s></s> 二十多萬不可能!人現在在哪兒呢?</s>	surprise	angry
<s> 說有二十多萬呢! 二十多萬? 是呀!我也納悶,馬軍怎麼會有那麼多錢? 據我瞭解,那不是馬軍的錢,那是咱們林業局的錢,是公款。 公款怎麼弄到哈爾濱去了? 節前馬軍在哈爾濱買了兩臺印刷機,給人家匯去了一百萬塊錢,買機器花了八十六萬,還剩下十四萬在他們那邊沒給匯回來,可能就是這個錢。 讓他們給動用了? 那肯定唄。 他們怎麼說有二十多萬呢? 二十多萬不可能!人現在在哪兒呢? </s></s> 帶到哈爾濱去了。你放心,我們有一個警員跟着,情況弄清楚就回來了。</s>	neutral	neutral
<s> 二十多萬? 是呀!我也納悶,馬軍怎麼會有那麼多錢? 據我瞭解,那不是馬軍的錢,那是咱們林業局的錢,是公款。 公款怎麼弄到哈爾濱去了? 節前馬軍在哈爾濱買了兩臺印刷機,給人家匯去了一百萬塊錢,買機器花了八十六萬,還剩下十四萬在他們那邊沒給匯回來,可能就是這個錢。 讓他們給動用了? 那肯定唄。 他們怎麼說有二十多萬呢? 二十多萬不可能!人現在在哪兒呢? 帶到哈爾濱去了。你放心,我們有一個警員跟着,情況弄清楚就回來了。 </s></s> 這熊孩子辦事總這麼不利索!剩下的錢你不趕緊要回來放在外邊幹什麼?那還不給人家挪用?</s>	angry	angry
<s> 是呀!我也納悶,馬軍怎麼會有那麼多錢? 據我瞭解,那不是馬軍的錢,那是咱們林業局的錢,是公款。 公款怎麼弄到哈爾濱去了? 節前馬軍在哈爾濱買了兩臺印刷機,給人家匯去了一百萬塊錢,買機器花了八十六萬,還剩下十四萬在他們那邊沒給匯回來,可能就是這個錢。 讓他們給動用了? 那肯定唄。 他們怎麼說有二十多萬呢? 二十多萬不可能!人現在在哪兒呢? 帶到哈爾濱去了。你放心,我們有一個警員跟着,情況弄清楚就回來了。 這熊孩子辦事總這麼不利索!剩下的錢你不趕緊要回來放在外邊幹什麼?那還不給人家挪用? </s></s> 很可能給挪用了。馬軍是個機靈孩子,他不會幹傻事的。</s>	neutral	neutral
<s></s></s> 你在他那裏究竟有多少錢?</s>	surprise	neutral
<s> 你在他那裏究竟有多少錢? </s></s> 十四萬。</s>	neutral	neutral
<s> 你在他那裏究竟有多少錢? 十四萬。 </s></s> 再沒有別的錢了嗎?</s>	surprise	surprise
<s> 你在他那裏究竟有多少錢? 十四萬。 再沒有別的錢了嗎? </s></s> 沒有了。</s>	neutral	neutral
<s></s></s> 馬總!</s>	surprise	surprise
<s> 馬總! </s></s> 馮科長!劉所長!請進!</s>	joy	neutral
<s> 馬總! 馮科長!劉所長!請進! </s></s> 有關於馬軍的消息,給你彙報一下。</s>	neutral	neutral
<s> 馬總! 馮科長!劉所長!請進! 有關於馬軍的消息,給你彙報一下。 </s></s> 好好!快請坐。</s>	joy	surprise
<s> 馬總! 馮科長!劉所長!請進! 有關於馬軍的消息,給你彙報一下。 好好!快請坐。 </s></s> 劉所長說吧,是他接的電話。</s>	neutral	neutral
<s> 馬總! 馮科長!劉所長!請進! 有關於馬軍的消息,給你彙報一下。 好好!快請坐。 劉所長說吧,是他接的電話。 </s></s> “那邊已經把情況基本查清楚了。事情的經過是這樣的:哈爾濱那個印刷廠,就是馬軍買印刷機的前進印刷廠,這個廠的廠長苗鳳山,從廣告上看到了一個消息,說有個投資公司在集資,利息很高。苗</s>	neutral	neutral
<s></s></s> 你分析的很對。這兩個問題我看不難說清楚。第一個,他替馬軍投資有沒有徵求馬軍的意見?只有馬軍自己清楚,他們可以當面對質。第二,馬軍手裏究竟有沒有錢?有多少錢?在財務上一查就知道了。據我所知,他除了從公家借款,不可能再有別的錢了。那麼多的錢,除了公家誰拿得出來?</s>	neutral	surprise
<s> 你分析的很對。這兩個問題我看不難說清楚。第一個,他替馬軍投資有沒有徵求馬軍的意見?只有馬軍自己清楚,他們可以當面對質。第二,馬軍手裏究竟有沒有錢?有多少錢?在財務上一查就知道了。據我所知,他除了從公家借款,不可能再有別的錢了。那麼多的錢,除了公家誰拿得出來? </s></s> 馬總說的有道理,事情不難說清楚,不過得有證據。</s>	neutral	fear
<s> 你分析的很對。這兩個問題我看不難說清楚。第一個,他替馬軍投資有沒有徵求馬軍的意見?只有馬軍自己清楚,他們可以當面對質。第二,馬軍手裏究竟有沒有錢?有多少錢?在財務上一查就知道了。據我所知,他除了從公家借款,不可能再有別的錢了。那麼多的錢,除了公家誰拿得出來? 馬總說的有道理,事情不難說清楚,不過得有證據。 </s></s> 對,是得有證據。這樣吧,給馬總就彙報到這,咱們到財務科去一下,讓他們幫忙查一下帳,提供一個證明。</s>	neutral	neutral
<s> 你分析的很對。這兩個問題我看不難說清楚。第一個,他替馬軍投資有沒有徵求馬軍的意見?只有馬軍自己清楚,他們可以當面對質。第二,馬軍手裏究竟有沒有錢?有多少錢?在財務上一查就知道了。據我所知,他除了從公家借款,不可能再有別的錢了。那麼多的錢,除了公家誰拿得出來? 馬總說的有道理,事情不難說清楚,不過得有證據。 對,是得有證據。這樣吧,給馬總就彙報到這,咱們到財務科去一下,讓他們幫忙查一下帳,提供一個證明。 </s></s> 好的。</s>	neutral	neutral
<s> 你分析的很對。這兩個問題我看不難說清楚。第一個,他替馬軍投資有沒有徵求馬軍的意見?只有馬軍自己清楚,他們可以當面對質。第二,馬軍手裏究竟有沒有錢?有多少錢?在財務上一查就知道了。據我所知,他除了從公家借款,不可能再有別的錢了。那麼多的錢,除了公家誰拿得出來? 馬總說的有道理,事情不難說清楚,不過得有證據。 對,是得有證據。這樣吧,給馬總就彙報到這,咱們到財務科去一下,讓他們幫忙查一下帳,提供一個證明。 好的。 </s></s> 那就辛苦二位了。</s>	sadness	joy
<s> 你分析的很對。這兩個問題我看不難說清楚。第一個,他替馬軍投資有沒有徵求馬軍的意見?只有馬軍自己清楚,他們可以當面對質。第二,馬軍手裏究竟有沒有錢?有多少錢?在財務上一查就知道了。據我所知,他除了從公家借款,不可能再有別的錢了。那麼多的錢,除了公家誰拿得出來? 馬總說的有道理,事情不難說清楚,不過得有證據。 對,是得有證據。這樣吧,給馬總就彙報到這,咱們到財務科去一下,讓他們幫忙查一下帳,提供一個證明。 好的。 那就辛苦二位了。 </s></s> 不客氣。馬總再見!</s>	joy	joy
<s> 你分析的很對。這兩個問題我看不難說清楚。第一個,他替馬軍投資有沒有徵求馬軍的意見?只有馬軍自己清楚,他們可以當面對質。第二,馬軍手裏究竟有沒有錢?有多少錢?在財務上一查就知道了。據我所知,他除了從公家借款,不可能再有別的錢了。那麼多的錢,除了公家誰拿得出來? 馬總說的有道理,事情不難說清楚,不過得有證據。 對,是得有證據。這樣吧,給馬總就彙報到這,咱們到財務科去一下,讓他們幫忙查一下帳,提供一個證明。 好的。 那就辛苦二位了。 不客氣。馬總再見! </s></s> 再見!</s>	joy	joy
<s></s></s> 小吳!吳科長!</s>	joy	surprise
<s> 小吳!吳科長! </s></s> 有事嗎?怎麼不進來?</s>	surprise	surprise
<s> 小吳!吳科長! 有事嗎?怎麼不進來? </s></s> 有事。大家都忙,不方便,到我們那裏去吧。</s>	neutral	neutral
<s> 小吳!吳科長! 有事嗎?怎麼不進來? 有事。大家都忙,不方便,到我們那裏去吧。 </s></s> 好的。</s>	neutral	neutral
<s></s></s> 科長!</s>	surprise	surprise
<s> 科長! </s></s> 有事嗎?出差讓我去!</s>	joy	surprise
<s> 科長! 有事嗎?出差讓我去! </s></s> “</s>	neutral	neutral
<s></s></s> 幹啥?</s>	surprise	surprise
<s> 幹啥? </s></s> 有用。</s>	joy	neutral
<s> 幹啥? 有用。 </s></s> 有啥用?</s>	surprise	surprise
<s> 幹啥? 有用。 有啥用? </s></s> 馬軍出事了!</s>	fear	fear
<s> 幹啥? 有用。 有啥用? 馬軍出事了! </s></s> “</s>	neutral	neutral
<s></s></s> 出啥事了?</s>	surprise	surprise
<s> 出啥事了? </s></s> 他不是借了一百萬買印刷機嗎?買印刷機花了八十六萬,剩下的十四萬他沒拿回來,存在印刷廠,結果被人挪用了。</s>	sadness	fear
<s> 出啥事了? 他不是借了一百萬買印刷機嗎?買印刷機花了八十六萬,剩下的十四萬他沒拿回來,存在印刷廠,結果被人挪用了。 </s></s> 被印刷廠挪用了?</s>	surprise	surprise
<s> 出啥事了? 他不是借了一百萬買印刷機嗎?買印刷機花了八十六萬,剩下的十四萬他沒拿回來,存在印刷廠,結果被人挪用了。 被印刷廠挪用了? </s></s> 那個印刷廠的廠長給挪用了。光挪用還問題不大,他挪用不是幹正事,是去販毒!</s>	angry	angry
<s> 出啥事了? 他不是借了一百萬買印刷機嗎?買印刷機花了八十六萬,剩下的十四萬他沒拿回來,存在印刷廠,結果被人挪用了。 被印刷廠挪用了? 那個印刷廠的廠長給挪用了。光挪用還問題不大,他挪用不是幹正事,是去販毒! </s></s> 販毒?</s>	surprise	surprise
<s> 出啥事了? 他不是借了一百萬買印刷機嗎?買印刷機花了八十六萬,剩下的十四萬他沒拿回來,存在印刷廠,結果被人挪用了。 被印刷廠挪用了? 那個印刷廠的廠長給挪用了。光挪用還問題不大,他挪用不是幹正事,是去販毒! 販毒? </s></s> 販毒?那可完了!</s>	joy	fear
<s> 出啥事了? 他不是借了一百萬買印刷機嗎?買印刷機花了八十六萬,剩下的十四萬他沒拿回來,存在印刷廠,結果被人挪用了。 被印刷廠挪用了? 那個印刷廠的廠長給挪用了。光挪用還問題不大,他挪用不是幹正事,是去販毒! 販毒? 販毒?那可完了! </s></s> “倒不是廠長去販毒。他是給一個什麼公司去投資,想得點利息,不想那個公司是個販毒團伙,用集資的辦法籌集毒資。他一投資這不就沾包了?</s>	angry	fear
<s></s></s> 他投資跟馬軍有啥關係?</s>	surprise	surprise
<s> 他投資跟馬軍有啥關係? </s></s> 他不說投資的錢是他的,他說是馬軍的錢,投錢是經過馬軍同意的。</s>	neutral	neutral
<s> 他投資跟馬軍有啥關係? 他不說投資的錢是他的,他說是馬軍的錢,投錢是經過馬軍同意的。 </s></s> 栽贓陷害!</s>	angry	angry
<s> 他投資跟馬軍有啥關係? 他不說投資的錢是他的,他說是馬軍的錢,投錢是經過馬軍同意的。 栽贓陷害! </s></s> 馬軍根本就不可能同意他往那裏投錢!</s>	angry	angry
<s></s></s> 對呀。其實那個廠長也不知道那是販毒團伙,要知道他也不會投的。可事實是你已經投了。你說你不知道,誰信呀?誰能證明你不知道?</s>	neutral	fear
<s> 對呀。其實那個廠長也不知道那是販毒團伙,要知道他也不會投的。可事實是你已經投了。你說你不知道,誰信呀?誰能證明你不知道? </s></s> 咱們能給他證明嗎?</s>	angry	surprise
<s> 對呀。其實那個廠長也不知道那是販毒團伙,要知道他也不會投的。可事實是你已經投了。你說你不知道,誰信呀?誰能證明你不知道? 咱們能給他證明嗎? </s></s> 咱們證明不了,這事只有他自己去說清楚了。咱們要給他證明的是另一件事。</s>	neutral	neutral
<s> 對呀。其實那個廠長也不知道那是販毒團伙,要知道他也不會投的。可事實是你已經投了。你說你不知道,誰信呀?誰能證明你不知道? 咱們能給他證明嗎? 咱們證明不了,這事只有他自己去說清楚了。咱們要給他證明的是另一件事。 </s></s> 證明啥事?</s>	surprise	surprise
<s> 對呀。其實那個廠長也不知道那是販毒團伙,要知道他也不會投的。可事實是你已經投了。你說你不知道,誰信呀?誰能證明你不知道? 咱們能給他證明嗎? 咱們證明不了,這事只有他自己去說清楚了。咱們要給他證明的是另一件事。 證明啥事? </s></s> 那個廠長說,馬軍的錢有二十多萬。馬軍在咱們這的欠款有二十多萬嗎?</s>	surprise	surprise
<s> 對呀。其實那個廠長也不知道那是販毒團伙,要知道他也不會投的。可事實是你已經投了。你說你不知道,誰信呀?誰能證明你不知道? 咱們能給他證明嗎? 咱們證明不了,這事只有他自己去說清楚了。咱們要給他證明的是另一件事。 證明啥事? 那個廠長說,馬軍的錢有二十多萬。馬軍在咱們這的欠款有二十多萬嗎? </s></s> 沒有,就是這次買機器剩下的十四萬,再沒有別的欠款。</s>	neutral	neutral
<s> 對呀。其實那個廠長也不知道那是販毒團伙,要知道他也不會投的。可事實是你已經投了。你說你不知道,誰信呀?誰能證明你不知道? 咱們能給他證明嗎? 咱們證明不了,這事只有他自己去說清楚了。咱們要給他證明的是另一件事。 證明啥事? 那個廠長說,馬軍的錢有二十多萬。馬軍在咱們這的欠款有二十多萬嗎? 沒有,就是這次買機器剩下的十四萬,再沒有別的欠款。 </s></s> 咱們證明他只有這麼多錢就行了。估計他也不會再有別的錢了,有也跟咱們沒關係。</s>	neutral	neutral
<s> 對呀。其實那個廠長也不知道那是販毒團伙,要知道他也不會投的。可事實是你已經投了。你說你不知道,誰信呀?誰能證明你不知道? 咱們能給他證明嗎? 咱們證明不了,這事只有他自己去說清楚了。咱們要給他證明的是另一件事。 證明啥事? 那個廠長說,馬軍的錢有二十多萬。馬軍在咱們這的欠款有二十多萬嗎? 沒有,就是這次買機器剩下的十四萬,再沒有別的欠款。 咱們證明他只有這麼多錢就行了。估計他也不會再有別的錢了,有也跟咱們沒關係。 </s></s> 這好辦。弄好了交給誰?</s>	surprise	surprise
<s> 對呀。其實那個廠長也不知道那是販毒團伙,要知道他也不會投的。可事實是你已經投了。你說你不知道,誰信呀?誰能證明你不知道? 咱們能給他證明嗎? 咱們證明不了,這事只有他自己去說清楚了。咱們要給他證明的是另一件事。 證明啥事? 那個廠長說,馬軍的錢有二十多萬。馬軍在咱們這的欠款有二十多萬嗎? 沒有,就是這次買機器剩下的十四萬,再沒有別的欠款。 咱們證明他只有這麼多錢就行了。估計他也不會再有別的錢了,有也跟咱們沒關係。 這好辦。弄好了交給誰? </s></s> 給安保科。</s>	neutral	neutral
<s> 對呀。其實那個廠長也不知道那是販毒團伙,要知道他也不會投的。可事實是你已經投了。你說你不知道,誰信呀?誰能證明你不知道? 咱們能給他證明嗎? 咱們證明不了,這事只有他自己去說清楚了。咱們要給他證明的是另一件事。 證明啥事? 那個廠長說,馬軍的錢有二十多萬。馬軍在咱們這的欠款有二十多萬嗎? 沒有,就是這次買機器剩下的十四萬,再沒有別的欠款。 咱們證明他只有這麼多錢就行了。估計他也不會再有別的錢了,有也跟咱們沒關係。 這好辦。弄好了交給誰? 給安保科。 </s></s> 科長,你知道嗎?他買印刷機的事,除了咱們還有別的人去查過呢。</s>	surprise	fear
<s> 對呀。其實那個廠長也不知道那是販毒團伙,要知道他也不會投的。可事實是你已經投了。你說你不知道,誰信呀?誰能證明你不知道? 咱們能給他證明嗎? 咱們證明不了,這事只有他自己去說清楚了。咱們要給他證明的是另一件事。 證明啥事? 那個廠長說,馬軍的錢有二十多萬。馬軍在咱們這的欠款有二十多萬嗎? 沒有,就是這次買機器剩下的十四萬,再沒有別的欠款。 咱們證明他只有這麼多錢就行了。估計他也不會再有別的錢了,有也跟咱們沒關係。 這好辦。弄好了交給誰? 給安保科。 科長,你知道嗎?他買印刷機的事,除了咱們還有別的人去查過呢。 </s></s> 去查什麼?</s>	surprise	surprise
<s> 咱們能給他證明嗎? 咱們證明不了,這事只有他自己去說清楚了。咱們要給他證明的是另一件事。 證明啥事? 那個廠長說,馬軍的錢有二十多萬。馬軍在咱們這的欠款有二十多萬嗎? 沒有,就是這次買機器剩下的十四萬,再沒有別的欠款。 咱們證明他只有這麼多錢就行了。估計他也不會再有別的錢了,有也跟咱們沒關係。 這好辦。弄好了交給誰? 給安保科。 科長,你知道嗎?他買印刷機的事,除了咱們還有別的人去查過呢。 去查什麼? </s></s> 聽說機器質量不好,是二手貨,可能也有錢的問題吧?</s>	fear	fear
<s> 咱們證明不了,這事只有他自己去說清楚了。咱們要給他證明的是另一件事。 證明啥事? 那個廠長說,馬軍的錢有二十多萬。馬軍在咱們這的欠款有二十多萬嗎? 沒有,就是這次買機器剩下的十四萬,再沒有別的欠款。 咱們證明他只有這麼多錢就行了。估計他也不會再有別的錢了,有也跟咱們沒關係。 這好辦。弄好了交給誰? 給安保科。 科長,你知道嗎?他買印刷機的事,除了咱們還有別的人去查過呢。 去查什麼? 聽說機器質量不好,是二手貨,可能也有錢的問題吧? </s></s> 誰去查的?</s>	surprise	surprise
<s> 證明啥事? 那個廠長說,馬軍的錢有二十多萬。馬軍在咱們這的欠款有二十多萬嗎? 沒有,就是這次買機器剩下的十四萬,再沒有別的欠款。 咱們證明他只有這麼多錢就行了。估計他也不會再有別的錢了,有也跟咱們沒關係。 這好辦。弄好了交給誰? 給安保科。 科長,你知道嗎?他買印刷機的事,除了咱們還有別的人去查過呢。 去查什麼? 聽說機器質量不好,是二手貨,可能也有錢的問題吧? 誰去查的? </s></s> 他們印刷廠的人。</s>	neutral	neutral
<s> 那個廠長說,馬軍的錢有二十多萬。馬軍在咱們這的欠款有二十多萬嗎? 沒有,就是這次買機器剩下的十四萬,再沒有別的欠款。 咱們證明他只有這麼多錢就行了。估計他也不會再有別的錢了,有也跟咱們沒關係。 這好辦。弄好了交給誰? 給安保科。 科長,你知道嗎?他買印刷機的事,除了咱們還有別的人去查過呢。 去查什麼? 聽說機器質量不好,是二手貨,可能也有錢的問題吧? 誰去查的? 他們印刷廠的人。 </s></s> 別的事咱們不管,帳上的事咱們弄清楚就行了。</s>	neutral	neutral
<s> 沒有,就是這次買機器剩下的十四萬,再沒有別的欠款。 咱們證明他只有這麼多錢就行了。估計他也不會再有別的錢了,有也跟咱們沒關係。 這好辦。弄好了交給誰? 給安保科。 科長,你知道嗎?他買印刷機的事,除了咱們還有別的人去查過呢。 去查什麼? 聽說機器質量不好,是二手貨,可能也有錢的問題吧? 誰去查的? 他們印刷廠的人。 別的事咱們不管,帳上的事咱們弄清楚就行了。 </s></s> 對。</s>	neutral	neutral
<s> 咱們證明他只有這麼多錢就行了。估計他也不會再有別的錢了,有也跟咱們沒關係。 這好辦。弄好了交給誰? 給安保科。 科長,你知道嗎?他買印刷機的事,除了咱們還有別的人去查過呢。 去查什麼? 聽說機器質量不好,是二手貨,可能也有錢的問題吧? 誰去查的? 他們印刷廠的人。 別的事咱們不管,帳上的事咱們弄清楚就行了。 對。 </s></s> 以後再有類似的事,有欠款不還的,咱們一定要催他們及時歸還,長期不還的就從工資里扣。錢存在外邊就失控,難免不出事。這次馬軍的餘款如果及時交回來,別存在哈爾濱,也不會出事。</s>	neutral	sadness
<s> 這好辦。弄好了交給誰? 給安保科。 科長,你知道嗎?他買印刷機的事,除了咱們還有別的人去查過呢。 去查什麼? 聽說機器質量不好,是二手貨,可能也有錢的問題吧? 誰去查的? 他們印刷廠的人。 別的事咱們不管,帳上的事咱們弄清楚就行了。 對。 以後再有類似的事,有欠款不還的,咱們一定要催他們及時歸還,長期不還的就從工資里扣。錢存在外邊就失控,難免不出事。這次馬軍的餘款如果及時交回來,別存在哈爾濱,也不會出事。 </s></s> 對。</s>	neutral	neutral
<s></s></s> 夏主任!</s>	surprise	surprise
<s> 夏主任! </s></s> 韓東,要上班去了?你先別走,有件事得跟你商量商量。</s>	surprise	surprise
<s></s></s> 小方,忙着呢?</s>	surprise	surprise
<s> 小方,忙着呢? </s></s> 韓師傅來了?</s>	surprise	surprise
<s> 小方,忙着呢? 韓師傅來了? </s></s> 還是你一個人嗎?</s>	neutral	surprise
<s> 小方,忙着呢? 韓師傅來了? 還是你一個人嗎? </s></s> 不,又來了一個師傅,她出去了。</s>	joy	neutral
<s> 小方,忙着呢? 韓師傅來了? 還是你一個人嗎? 不,又來了一個師傅,她出去了。 </s></s> 小方,有一樣東西不知道還在不在?</s>	surprise	surprise
<s> 小方,忙着呢? 韓師傅來了? 還是你一個人嗎? 不,又來了一個師傅,她出去了。 小方,有一樣東西不知道還在不在? </s></s> 啥東西?</s>	surprise	surprise
<s> 小方,忙着呢? 韓師傅來了? 還是你一個人嗎? 不,又來了一個師傅,她出去了。 小方,有一樣東西不知道還在不在? 啥東西? </s></s> “前些日子</s>	neutral	neutral
<s></s></s> 噢,那張紙呀,我撕了。你不是叫我撕了嗎?</s>	surprise	surprise
<s> 噢,那張紙呀,我撕了。你不是叫我撕了嗎? </s></s> 撕了就算了。</s>	neutral	neutral
<s> 噢,那張紙呀,我撕了。你不是叫我撕了嗎? 撕了就算了。 </s></s> 怎麼,又有用處了?</s>	surprise	surprise
<s> 噢,那張紙呀,我撕了。你不是叫我撕了嗎? 撕了就算了。 怎麼,又有用處了? </s></s> 沒什麼,算了。</s>	neutral	neutral
<s> 噢,那張紙呀,我撕了。你不是叫我撕了嗎? 撕了就算了。 怎麼,又有用處了? 沒什麼,算了。 </s></s> 別呀,我估計你可能用得着,就沒撕,你要嗎?</s>	fear	neutral
<s> 噢,那張紙呀,我撕了。你不是叫我撕了嗎? 撕了就算了。 怎麼,又有用處了? 沒什麼,算了。 別呀,我估計你可能用得着,就沒撕,你要嗎? </s></s> 還在嗎?那就給我吧。</s>	neutral	surprise
<s> 噢,那張紙呀,我撕了。你不是叫我撕了嗎? 撕了就算了。 怎麼,又有用處了? 沒什麼,算了。 別呀,我估計你可能用得着,就沒撕,你要嗎? 還在嗎?那就給我吧。 </s></s> 給你吧,我留着也沒用。</s>	neutral	neutral
<s></s></s> “你問她有這事兒沒有?</s>	angry	surprise
<s> “你問她有這事兒沒有? </s></s> 簡直是豈有此理!怎麼解決,讓我承認這個孩子?</s>	angry	angry
<s> “你問她有這事兒沒有? 簡直是豈有此理!怎麼解決,讓我承認這個孩子? </s></s> 你先不用承認這個孩子,你承認了也沒用。小常你給他說說。</s>	angry	neutral
<s></s></s> 行!你們說話算話?</s>	angry	surprise
<s> 行!你們說話算話? </s></s> “那當然!我們兩個都是負責這方面工作的,說話是算數的。你要不相信,我們寫個字據都行。你說呢?</s>	surprise	joy
<s></s></s> 不用了。</s>	neutral	neutral
<s> 不用了。 </s></s> 好。小常,你這就帶他倆上鎮政府登記。</s>	neutral	neutral
<s></s></s> 小常,謝謝你!</s>	joy	joy
<s> 小常,謝謝你! </s></s> 東哥!</s>	joy	surprise
<s> 小常,謝謝你! 東哥! </s></s> 東哥!</s>	joy	surprise
<s> 小常,謝謝你! 東哥! 東哥! </s></s> 你達到目的了?你到底要幹什麼?你不覺得你這樣做有點損,有點缺德嗎?</s>	surprise	angry
<s> 小常,謝謝你! 東哥! 東哥! 你達到目的了?你到底要幹什麼?你不覺得你這樣做有點損,有點缺德嗎? </s></s> 我什麼都不覺得。我就是喜歡你,愛你,想和你在一起。我爲自己過去做的事後悔。</s>	sadness	joy
<s> 小常,謝謝你! 東哥! 東哥! 你達到目的了?你到底要幹什麼?你不覺得你這樣做有點損,有點缺德嗎? 我什麼都不覺得。我就是喜歡你,愛你,想和你在一起。我爲自己過去做的事後悔。 </s></s> 後悔你就拿我當墊背的?你爲什麼不去找他?</s>	angry	angry
<s> 小常,謝謝你! 東哥! 東哥! 你達到目的了?你到底要幹什麼?你不覺得你這樣做有點損,有點缺德嗎? 我什麼都不覺得。我就是喜歡你,愛你,想和你在一起。我爲自己過去做的事後悔。 後悔你就拿我當墊背的?你爲什麼不去找他? </s></s> 我恨他!我根本不願理他。</s>	angry	angry
<s> 小常,謝謝你! 東哥! 東哥! 你達到目的了?你到底要幹什麼?你不覺得你這樣做有點損,有點缺德嗎? 我什麼都不覺得。我就是喜歡你,愛你,想和你在一起。我爲自己過去做的事後悔。 後悔你就拿我當墊背的?你爲什麼不去找他? 我恨他!我根本不願理他。 </s></s> 恨他還懷了他的孩子?不願理他爲啥不把孩子打掉?</s>	angry	angry
<s> 小常,謝謝你! 東哥! 東哥! 你達到目的了?你到底要幹什麼?你不覺得你這樣做有點損,有點缺德嗎? 我什麼都不覺得。我就是喜歡你,愛你,想和你在一起。我爲自己過去做的事後悔。 後悔你就拿我當墊背的?你爲什麼不去找他? 我恨他!我根本不願理他。 恨他還懷了他的孩子?不願理他爲啥不把孩子打掉? </s></s> 我也不是不想打。</s>	angry	sadness
<s> 小常,謝謝你! 東哥! 東哥! 你達到目的了?你到底要幹什麼?你不覺得你這樣做有點損,有點缺德嗎? 我什麼都不覺得。我就是喜歡你,愛你,想和你在一起。我爲自己過去做的事後悔。 後悔你就拿我當墊背的?你爲什麼不去找他? 我恨他!我根本不願理他。 恨他還懷了他的孩子?不願理他爲啥不把孩子打掉? 我也不是不想打。 </s></s> 你得了吧,誰相信!</s>	angry	disgust
<s> 小常,謝謝你! 東哥! 東哥! 你達到目的了?你到底要幹什麼?你不覺得你這樣做有點損,有點缺德嗎? 我什麼都不覺得。我就是喜歡你,愛你,想和你在一起。我爲自己過去做的事後悔。 後悔你就拿我當墊背的?你爲什麼不去找他? 我恨他!我根本不願理他。 恨他還懷了他的孩子?不願理他爲啥不把孩子打掉? 我也不是不想打。 你得了吧,誰相信! </s></s> 那你跟曉華不是也好過嗎?</s>	sadness	angry
<s> 東哥! 東哥! 你達到目的了?你到底要幹什麼?你不覺得你這樣做有點損,有點缺德嗎? 我什麼都不覺得。我就是喜歡你,愛你,想和你在一起。我爲自己過去做的事後悔。 後悔你就拿我當墊背的?你爲什麼不去找他? 我恨他!我根本不願理他。 恨他還懷了他的孩子?不願理他爲啥不把孩子打掉? 我也不是不想打。 你得了吧,誰相信! 那你跟曉華不是也好過嗎? </s></s> 你別跟她比。我們也沒你這麼多亂七八糟的事兒!</s>	angry	disgust
<s> 東哥! 你達到目的了?你到底要幹什麼?你不覺得你這樣做有點損,有點缺德嗎? 我什麼都不覺得。我就是喜歡你,愛你,想和你在一起。我爲自己過去做的事後悔。 後悔你就拿我當墊背的?你爲什麼不去找他? 我恨他!我根本不願理他。 恨他還懷了他的孩子?不願理他爲啥不把孩子打掉? 我也不是不想打。 你得了吧,誰相信! 那你跟曉華不是也好過嗎? 你別跟她比。我們也沒你這麼多亂七八糟的事兒! </s></s> 你把那信還給我吧?</s>	angry	fear
<s> 你達到目的了?你到底要幹什麼?你不覺得你這樣做有點損,有點缺德嗎? 我什麼都不覺得。我就是喜歡你,愛你,想和你在一起。我爲自己過去做的事後悔。 後悔你就拿我當墊背的?你爲什麼不去找他? 我恨他!我根本不願理他。 恨他還懷了他的孩子?不願理他爲啥不把孩子打掉? 我也不是不想打。 你得了吧,誰相信! 那你跟曉華不是也好過嗎? 你別跟她比。我們也沒你這麼多亂七八糟的事兒! 你把那信還給我吧? </s></s> 什麼信?你不是說我造謠嗎?</s>	angry	angry
<s> 我什麼都不覺得。我就是喜歡你,愛你,想和你在一起。我爲自己過去做的事後悔。 後悔你就拿我當墊背的?你爲什麼不去找他? 我恨他!我根本不願理他。 恨他還懷了他的孩子?不願理他爲啥不把孩子打掉? 我也不是不想打。 你得了吧,誰相信! 那你跟曉華不是也好過嗎? 你別跟她比。我們也沒你這麼多亂七八糟的事兒! 你把那信還給我吧? 什麼信?你不是說我造謠嗎? </s></s> 我知道我錯了。你還留着它幹啥?</s>	angry	surprise
<s> 後悔你就拿我當墊背的?你爲什麼不去找他? 我恨他!我根本不願理他。 恨他還懷了他的孩子?不願理他爲啥不把孩子打掉? 我也不是不想打。 你得了吧,誰相信! 那你跟曉華不是也好過嗎? 你別跟她比。我們也沒你這麼多亂七八糟的事兒! 你把那信還給我吧? 什麼信?你不是說我造謠嗎? 我知道我錯了。你還留着它幹啥? </s></s> 你放心,我不會給別人看的。但我現在還不能給你,怕你以後再賴帳。</s>	neutral	disgust
<s> 我恨他!我根本不願理他。 恨他還懷了他的孩子?不願理他爲啥不把孩子打掉? 我也不是不想打。 你得了吧,誰相信! 那你跟曉華不是也好過嗎? 你別跟她比。我們也沒你這麼多亂七八糟的事兒! 你把那信還給我吧? 什麼信?你不是說我造謠嗎? 我知道我錯了。你還留着它幹啥? 你放心,我不會給別人看的。但我現在還不能給你,怕你以後再賴帳。 </s></s> 你就不能原諒我一次?</s>	sadness	sadness
<s> 恨他還懷了他的孩子?不願理他爲啥不把孩子打掉? 我也不是不想打。 你得了吧,誰相信! 那你跟曉華不是也好過嗎? 你別跟她比。我們也沒你這麼多亂七八糟的事兒! 你把那信還給我吧? 什麼信?你不是說我造謠嗎? 我知道我錯了。你還留着它幹啥? 你放心,我不會給別人看的。但我現在還不能給你,怕你以後再賴帳。 你就不能原諒我一次? </s></s> 行了!生你的孩子去吧!</s>	angry	angry
<s></s></s> 東哥!</s>	surprise	surprise
<s> 東哥! </s></s> 還有啥事?</s>	surprise	surprise
<s> 東哥! 還有啥事? </s></s> 馬東出事了,你知道嗎?</s>	fear	surprise
<s> 東哥! 還有啥事? 馬東出事了,你知道嗎? </s></s> 你怎麼知道?</s>	surprise	surprise
<s> 東哥! 還有啥事? 馬東出事了,你知道嗎? 你怎麼知道? </s></s> 我怎麼不知道?他早晚要出事!</s>	surprise	disgust
<s> 東哥! 還有啥事? 馬東出事了,你知道嗎? 你怎麼知道? 我怎麼不知道?他早晚要出事! </s></s> 他出不出事跟你有啥關係?</s>	angry	angry
<s> 東哥! 還有啥事? 馬東出事了,你知道嗎? 你怎麼知道? 我怎麼不知道?他早晚要出事! 他出不出事跟你有啥關係? </s></s> 怎麼沒關係?你別忘了,我是印刷廠的職工,他是我們廠長。</s>	neutral	neutral
<s> 東哥! 還有啥事? 馬東出事了,你知道嗎? 你怎麼知道? 我怎麼不知道?他早晚要出事! 他出不出事跟你有啥關係? 怎麼沒關係?你別忘了,我是印刷廠的職工,他是我們廠長。 </s></s> 職工怎麼了?廠長怎麼了?</s>	surprise	disgust
<s> 東哥! 還有啥事? 馬東出事了,你知道嗎? 你怎麼知道? 我怎麼不知道?他早晚要出事! 他出不出事跟你有啥關係? 怎麼沒關係?你別忘了,我是印刷廠的職工,他是我們廠長。 職工怎麼了?廠長怎麼了? </s></s> 廠長的一舉一動我們都知道。</s>	neutral	neutral
<s> 東哥! 還有啥事? 馬東出事了,你知道嗎? 你怎麼知道? 我怎麼不知道?他早晚要出事! 他出不出事跟你有啥關係? 怎麼沒關係?你別忘了,我是印刷廠的職工,他是我們廠長。 職工怎麼了?廠長怎麼了? 廠長的一舉一動我們都知道。 </s></s> 你知道什麼了?</s>	surprise	surprise
<s> 東哥! 還有啥事? 馬東出事了,你知道嗎? 你怎麼知道? 我怎麼不知道?他早晚要出事! 他出不出事跟你有啥關係? 怎麼沒關係?你別忘了,我是印刷廠的職工,他是我們廠長。 職工怎麼了?廠長怎麼了? 廠長的一舉一動我們都知道。 你知道什麼了? </s></s> 他買印刷機的事我們就知道。</s>	neutral	neutral
<s> 還有啥事? 馬東出事了,你知道嗎? 你怎麼知道? 我怎麼不知道?他早晚要出事! 他出不出事跟你有啥關係? 怎麼沒關係?你別忘了,我是印刷廠的職工,他是我們廠長。 職工怎麼了?廠長怎麼了? 廠長的一舉一動我們都知道。 你知道什麼了? 他買印刷機的事我們就知道。 </s></s> 他買印刷機又怎麼樣?</s>	angry	surprise
<s> 馬東出事了,你知道嗎? 你怎麼知道? 我怎麼不知道?他早晚要出事! 他出不出事跟你有啥關係? 怎麼沒關係?你別忘了,我是印刷廠的職工,他是我們廠長。 職工怎麼了?廠長怎麼了? 廠長的一舉一動我們都知道。 你知道什麼了? 他買印刷機的事我們就知道。 他買印刷機又怎麼樣? </s></s> 買印刷機有貓兒匿!</s>	angry	surprise
<s> 你怎麼知道? 我怎麼不知道?他早晚要出事! 他出不出事跟你有啥關係? 怎麼沒關係?你別忘了,我是印刷廠的職工,他是我們廠長。 職工怎麼了?廠長怎麼了? 廠長的一舉一動我們都知道。 你知道什麼了? 他買印刷機的事我們就知道。 他買印刷機又怎麼樣? 買印刷機有貓兒匿! </s></s> 有貓兒匿?那你就去舉報吧?</s>	angry	disgust
<s> 我怎麼不知道?他早晚要出事! 他出不出事跟你有啥關係? 怎麼沒關係?你別忘了,我是印刷廠的職工,他是我們廠長。 職工怎麼了?廠長怎麼了? 廠長的一舉一動我們都知道。 你知道什麼了? 他買印刷機的事我們就知道。 他買印刷機又怎麼樣? 買印刷機有貓兒匿! 有貓兒匿?那你就去舉報吧? </s></s> 我有權力舉報,我也可以不舉報。他是你的朋友,還有白鴿,你們是一夥的。只要你答應一個條件,我就不舉報。</s>	joy	neutral
<s> 他出不出事跟你有啥關係? 怎麼沒關係?你別忘了,我是印刷廠的職工,他是我們廠長。 職工怎麼了?廠長怎麼了? 廠長的一舉一動我們都知道。 你知道什麼了? 他買印刷機的事我們就知道。 他買印刷機又怎麼樣? 買印刷機有貓兒匿! 有貓兒匿?那你就去舉報吧? 我有權力舉報,我也可以不舉報。他是你的朋友,還有白鴿,你們是一夥的。只要你答應一個條件,我就不舉報。 </s></s> 什麼條件?</s>	surprise	surprise
<s></s></s> 這個!這得是真的,不是假的!</s>	surprise	surprise
<s> 這個!這得是真的,不是假的! </s></s> 作夢吧,你!</s>	joy	disgust
<s> 這個!這得是真的,不是假的! 作夢吧,你! </s></s> 這不是作夢,這是真的!</s>	surprise	surprise
<s> 這個!這得是真的,不是假的! 作夢吧,你! 這不是作夢,這是真的! </s></s> 你想反悔?你剛纔是怎麼說的?</s>	surprise	angry
<s> 這個!這得是真的,不是假的! 作夢吧,你! 這不是作夢,這是真的! 你想反悔?你剛纔是怎麼說的? </s></s> 怎麼說都沒關係。說話不代表法律,這纔是具有法律效力的。</s>	joy	angry
<s> 這個!這得是真的,不是假的! 作夢吧,你! 這不是作夢,這是真的! 你想反悔?你剛纔是怎麼說的? 怎麼說都沒關係。說話不代表法律,這纔是具有法律效力的。 </s></s> 對你有效,對我無效!</s>	angry	disgust
<s> 這個!這得是真的,不是假的! 作夢吧,你! 這不是作夢,這是真的! 你想反悔?你剛纔是怎麼說的? 怎麼說都沒關係。說話不代表法律,這纔是具有法律效力的。 對你有效,對我無效! </s></s> 馬軍不是你的朋友嗎?</s>	neutral	surprise
<s> 這個!這得是真的,不是假的! 作夢吧,你! 這不是作夢,這是真的! 你想反悔?你剛纔是怎麼說的? 怎麼說都沒關係。說話不代表法律,這纔是具有法律效力的。 對你有效,對我無效! 馬軍不是你的朋友嗎? </s></s> 當然!</s>	joy	surprise
<s> 這個!這得是真的,不是假的! 作夢吧,你! 這不是作夢,這是真的! 你想反悔?你剛纔是怎麼說的? 怎麼說都沒關係。說話不代表法律,這纔是具有法律效力的。 對你有效,對我無效! 馬軍不是你的朋友嗎? 當然! </s></s> 那你爲啥不幫他?</s>	surprise	surprise
<s> 這個!這得是真的,不是假的! 作夢吧,你! 這不是作夢,這是真的! 你想反悔?你剛纔是怎麼說的? 怎麼說都沒關係。說話不代表法律,這纔是具有法律效力的。 對你有效,對我無效! 馬軍不是你的朋友嗎? 當然! 那你爲啥不幫他? </s></s> 他沒事,用不着幫!</s>	angry	neutral
<s> 這個!這得是真的,不是假的! 作夢吧,你! 這不是作夢,這是真的! 你想反悔?你剛纔是怎麼說的? 怎麼說都沒關係。說話不代表法律,這纔是具有法律效力的。 對你有效,對我無效! 馬軍不是你的朋友嗎? 當然! 那你爲啥不幫他? 他沒事,用不着幫! </s></s> 你會後悔的!</s>	angry	angry
<s> 作夢吧,你! 這不是作夢,這是真的! 你想反悔?你剛纔是怎麼說的? 怎麼說都沒關係。說話不代表法律,這纔是具有法律效力的。 對你有效,對我無效! 馬軍不是你的朋友嗎? 當然! 那你爲啥不幫他? 他沒事,用不着幫! 你會後悔的! </s></s> 我沒什麼可後悔的!</s>	disgust	disgust
<s> 這不是作夢,這是真的! 你想反悔?你剛纔是怎麼說的? 怎麼說都沒關係。說話不代表法律,這纔是具有法律效力的。 對你有效,對我無效! 馬軍不是你的朋友嗎? 當然! 那你爲啥不幫他? 他沒事,用不着幫! 你會後悔的! 我沒什麼可後悔的! </s></s> 東哥!</s>	neutral	angry
<s></s></s> 同志!我找所長。</s>	neutral	angry
<s> 同志!我找所長。 </s></s> 我就是。</s>	neutral	neutral
<s></s></s> 你貴姓?</s>	surprise	neutral
<s> 你貴姓? </s></s> 我姓劉。</s>	neutral	neutral
<s></s></s> 我有事情舉報。</s>	neutral	angry
<s> 我有事情舉報。 </s></s> 舉報?你請坐,舉報什麼事?</s>	surprise	surprise
<s></s></s> 我是林業局印刷廠的職工。我們印刷廠的廠長馬軍出事了,你知道嗎?</s>	fear	surprise
<s> 我是林業局印刷廠的職工。我們印刷廠的廠長馬軍出事了,你知道嗎? </s></s> 你是印刷廠的?你要舉報馬軍嗎?</s>	surprise	surprise
<s></s></s> 對。馬軍在哈爾濱買印刷機的時候有貪污公款的行爲。</s>	neutral	angry
<s> 對。馬軍在哈爾濱買印刷機的時候有貪污公款的行爲。 </s></s> 貪污公款?情況你瞭解嗎?</s>	surprise	surprise
<s></s></s> 我當然瞭解,我去調查過。</s>	neutral	angry
<s> 我當然瞭解,我去調查過。 </s></s> 那你把詳細情況談一談。</s>	neutral	surprise
<s></s></s> 就在今年九月分,國慶節之前,他在哈爾濱的前進印刷廠買了兩臺印刷機。這兩臺印刷機都不是新的,都是二手貨,買來就不能用。機器說是從前進印刷廠買的,其實根本不是他們的,不知道是從哪兒倒過來的。發票呢,又是另外一個印刷公司的。倒來的機器是七十六萬,賣給我們是八十六萬,發票開的也是八十六萬。</s>	neutral	neutral
<s> 就在今年九月分,國慶節之前,他在哈爾濱的前進印刷廠買了兩臺印刷機。這兩臺印刷機都不是新的,都是二手貨,買來就不能用。機器說是從前進印刷廠買的,其實根本不是他們的,不知道是從哪兒倒過來的。發票呢,又是另外一個印刷公司的。倒來的機器是七十六萬,賣給我們是八十六萬,發票開的也是八十六萬。 </s></s> 這些情況你是怎麼瞭解到的?</s>	surprise	surprise
<s></s></s> 我去調查的。</s>	neutral	neutral
<s> 我去調查的。 </s></s> 你到哪兒去調查的?</s>	surprise	surprise
<s></s></s> “他買機器的那個前進印刷廠,還有開發票的那個印刷公司我</s>	neutral	neutral
<s> “他買機器的那個前進印刷廠,還有開發票的那個印刷公司我 </s></s> 你都見了哪些人?</s>	surprise	surprise
<s></s></s> 開發票那個公司的銷售科長。前進印刷廠的技師,他是來幫我們安裝機器的,還有他們的廠長。花七十六買機器是廠長親自跟我說的。</s>	neutral	neutral
<s> 開發票那個公司的銷售科長。前進印刷廠的技師,他是來幫我們安裝機器的,還有他們的廠長。花七十六買機器是廠長親自跟我說的。 </s></s> 你爲什麼要去調查這件事?是誰讓你去的?</s>	surprise	surprise
<s></s></s> 我覺得這裏有問題,所以去調查,沒有誰讓我去。</s>	sadness	neutral
<s> 我覺得這裏有問題,所以去調查,沒有誰讓我去。 </s></s> 你覺得馬軍的問題是什麼?</s>	surprise	surprise
<s></s></s> 貪污公款。</s>	angry	angry
<s> 貪污公款。 </s></s> 他怎麼貪污公款了?</s>	surprise	surprise
<s></s></s> 人家花七十六萬買來的機器,賣給他八十六萬,這不是貪污嗎?</s>	angry	angry
<s> 人家花七十六萬買來的機器,賣給他八十六萬,這不是貪污嗎? </s></s> 照你這麼說,貪污的應該是那個廠長,不是馬軍。</s>	angry	neutral
<s></s></s> 廠長親自跟我說,馬軍花的是七十六萬,可是他向局裏報銷的是八十六萬,發票也是八十六萬。那是他們給他弄的假發票。這還不是貪污嗎?</s>	angry	angry
<s> 廠長親自跟我說,馬軍花的是七十六萬,可是他向局裏報銷的是八十六萬,發票也是八十六萬。那是他們給他弄的假發票。這還不是貪污嗎? </s></s> 要這樣的話,是可以構成貪污的。問題是他究竟向那個印刷廠支付了多少錢?是七十六萬還是八十六萬?</s>	angry	surprise
<s></s></s> 七十六萬!廠長親自說的。</s>	neutral	angry
<s> 七十六萬!廠長親自說的。 </s></s> 你說的情況都屬實嗎?</s>	surprise	surprise
<s></s></s> 當然。</s>	neutral	neutral
<s> 當然。 </s></s> 你能爲你提供的事實負責嗎?</s>	surprise	surprise
<s></s></s> 當然能。</s>	neutral	neutral
<s> 當然能。 </s></s> 那就請你在這份筆錄上籤個字。</s>	neutral	neutral
<s></s></s> 在這件事上如果有需要<unk>實的問題,我們可能還會找你。</s>	neutral	neutral
<s> 在這件事上如果有需要<unk>實的問題,我們可能還會找你。 </s></s> 行。</s>	neutral	neutral
<s> 在這件事上如果有需要<unk>實的問題,我們可能還會找你。 行。 </s></s> 那就這樣吧,謝謝你!</s>	joy	joy
<s></s></s> 不用!再見。</s>	joy	neutral
<s> 不用!再見。 </s></s> “再見!</s>	joy	neutral
<s></s></s> 馬總!</s>	surprise	surprise
<s> 馬總! </s></s> 馮科長!劉所長!快進來,請坐!</s>	joy	surprise
<s> 馬總! 馮科長!劉所長!快進來,請坐! </s></s> 哈爾濱那邊來電話了。</s>	neutral	surprise
<s> 馬總! 馮科長!劉所長!快進來,請坐! 哈爾濱那邊來電話了。 </s></s> 怎麼樣了?</s>	surprise	fear
<s> 馬總! 馮科長!劉所長!快進來,請坐! 哈爾濱那邊來電話了。 怎麼樣了? </s></s> 馬軍的問題解決了。涉毒的嫌疑排除了。那邊印刷廠廠長的涉毒嫌疑也排除了,他是屬於上當受騙。</s>	neutral	joy
<s> 馬總! 馮科長!劉所長!快進來,請坐! 哈爾濱那邊來電話了。 怎麼樣了? 馬軍的問題解決了。涉毒的嫌疑排除了。那邊印刷廠廠長的涉毒嫌疑也排除了,他是屬於上當受騙。 </s></s> 噢,那還不錯,都解決了。人也能回來了?</s>	surprise	joy
<s> 馬總! 馮科長!劉所長!快進來,請坐! 哈爾濱那邊來電話了。 怎麼樣了? 馬軍的問題解決了。涉毒的嫌疑排除了。那邊印刷廠廠長的涉毒嫌疑也排除了,他是屬於上當受騙。 噢,那還不錯,都解決了。人也能回來了? </s></s> 能回來,可能還有些手續上的事辦一下,很快,辦完就回來了。</s>	joy	joy
<s> 馬總! 馮科長!劉所長!快進來,請坐! 哈爾濱那邊來電話了。 怎麼樣了? 馬軍的問題解決了。涉毒的嫌疑排除了。那邊印刷廠廠長的涉毒嫌疑也排除了,他是屬於上當受騙。 噢,那還不錯,都解決了。人也能回來了? 能回來,可能還有些手續上的事辦一下,很快,辦完就回來了。 </s></s> 虛驚一場。</s>	joy	joy
<s> 馬總! 馮科長!劉所長!快進來,請坐! 哈爾濱那邊來電話了。 怎麼樣了? 馬軍的問題解決了。涉毒的嫌疑排除了。那邊印刷廠廠長的涉毒嫌疑也排除了,他是屬於上當受騙。 噢,那還不錯,都解決了。人也能回來了? 能回來,可能還有些手續上的事辦一下,很快,辦完就回來了。 虛驚一場。 </s></s> 是,弄得我們也挺緊張,怎麼還來個涉毒呢?根本不可能的事嘛!</s>	surprise	joy
<s> 馬總! 馮科長!劉所長!快進來,請坐! 哈爾濱那邊來電話了。 怎麼樣了? 馬軍的問題解決了。涉毒的嫌疑排除了。那邊印刷廠廠長的涉毒嫌疑也排除了,他是屬於上當受騙。 噢,那還不錯,都解決了。人也能回來了? 能回來,可能還有些手續上的事辦一下,很快,辦完就回來了。 虛驚一場。 是,弄得我們也挺緊張,怎麼還來個涉毒呢?根本不可能的事嘛! </s></s> 這事對馬軍是個教訓,任何時候都不要拖欠公款。</s>	neutral	neutral
<s> 馬總! 馮科長!劉所長!快進來,請坐! 哈爾濱那邊來電話了。 怎麼樣了? 馬軍的問題解決了。涉毒的嫌疑排除了。那邊印刷廠廠長的涉毒嫌疑也排除了,他是屬於上當受騙。 噢,那還不錯,都解決了。人也能回來了? 能回來,可能還有些手續上的事辦一下,很快,辦完就回來了。 虛驚一場。 是,弄得我們也挺緊張,怎麼還來個涉毒呢?根本不可能的事嘛! 這事對馬軍是個教訓,任何時候都不要拖欠公款。 </s></s> 他把錢還存在人家那邊,那不是給人家提供方便嗎?</s>	angry	disgust
<s> 馮科長!劉所長!快進來,請坐! 哈爾濱那邊來電話了。 怎麼樣了? 馬軍的問題解決了。涉毒的嫌疑排除了。那邊印刷廠廠長的涉毒嫌疑也排除了,他是屬於上當受騙。 噢,那還不錯,都解決了。人也能回來了? 能回來,可能還有些手續上的事辦一下,很快,辦完就回來了。 虛驚一場。 是,弄得我們也挺緊張,怎麼還來個涉毒呢?根本不可能的事嘛! 這事對馬軍是個教訓,任何時候都不要拖欠公款。 他把錢還存在人家那邊,那不是給人家提供方便嗎? </s></s> 人回來就沒事了吧?</s>	neutral	fear
<s> 哈爾濱那邊來電話了。 怎麼樣了? 馬軍的問題解決了。涉毒的嫌疑排除了。那邊印刷廠廠長的涉毒嫌疑也排除了,他是屬於上當受騙。 噢,那還不錯,都解決了。人也能回來了? 能回來,可能還有些手續上的事辦一下,很快,辦完就回來了。 虛驚一場。 是,弄得我們也挺緊張,怎麼還來個涉毒呢?根本不可能的事嘛! 這事對馬軍是個教訓,任何時候都不要拖欠公款。 他把錢還存在人家那邊,那不是給人家提供方便嗎? 人回來就沒事了吧? </s></s> 人是沒事了,可是錢的問題得解決呀。</s>	neutral	neutral
<s> 怎麼樣了? 馬軍的問題解決了。涉毒的嫌疑排除了。那邊印刷廠廠長的涉毒嫌疑也排除了,他是屬於上當受騙。 噢,那還不錯,都解決了。人也能回來了? 能回來,可能還有些手續上的事辦一下,很快,辦完就回來了。 虛驚一場。 是,弄得我們也挺緊張,怎麼還來個涉毒呢?根本不可能的事嘛! 這事對馬軍是個教訓,任何時候都不要拖欠公款。 他把錢還存在人家那邊,那不是給人家提供方便嗎? 人回來就沒事了吧? 人是沒事了,可是錢的問題得解決呀。 </s></s> 錢的問題?</s>	surprise	surprise
<s> 馬軍的問題解決了。涉毒的嫌疑排除了。那邊印刷廠廠長的涉毒嫌疑也排除了,他是屬於上當受騙。 噢,那還不錯,都解決了。人也能回來了? 能回來,可能還有些手續上的事辦一下,很快,辦完就回來了。 虛驚一場。 是,弄得我們也挺緊張,怎麼還來個涉毒呢?根本不可能的事嘛! 這事對馬軍是個教訓,任何時候都不要拖欠公款。 他把錢還存在人家那邊,那不是給人家提供方便嗎? 人回來就沒事了吧? 人是沒事了,可是錢的問題得解決呀。 錢的問題? </s></s> 是呀。你投進去的三十萬,那是毒資,沒收了,不會給你了。這裏不是還有馬軍的十四萬呢嗎?</s>	disgust	fear
<s> 噢,那還不錯,都解決了。人也能回來了? 能回來,可能還有些手續上的事辦一下,很快,辦完就回來了。 虛驚一場。 是,弄得我們也挺緊張,怎麼還來個涉毒呢?根本不可能的事嘛! 這事對馬軍是個教訓,任何時候都不要拖欠公款。 他把錢還存在人家那邊,那不是給人家提供方便嗎? 人回來就沒事了吧? 人是沒事了,可是錢的問題得解決呀。 錢的問題? 是呀。你投進去的三十萬,那是毒資,沒收了,不會給你了。這裏不是還有馬軍的十四萬呢嗎? </s></s> 到底是十四萬還是二十萬?</s>	surprise	surprise
<s> 能回來,可能還有些手續上的事辦一下,很快,辦完就回來了。 虛驚一場。 是,弄得我們也挺緊張,怎麼還來個涉毒呢?根本不可能的事嘛! 這事對馬軍是個教訓,任何時候都不要拖欠公款。 他把錢還存在人家那邊,那不是給人家提供方便嗎? 人回來就沒事了吧? 人是沒事了,可是錢的問題得解決呀。 錢的問題? 是呀。你投進去的三十萬,那是毒資,沒收了,不會給你了。這裏不是還有馬軍的十四萬呢嗎? 到底是十四萬還是二十萬? </s></s> 這個事也說清楚了,不是二十萬,是十四萬,就是他買機器剩下的那十四萬塊錢。</s>	neutral	neutral
<s> 虛驚一場。 是,弄得我們也挺緊張,怎麼還來個涉毒呢?根本不可能的事嘛! 這事對馬軍是個教訓,任何時候都不要拖欠公款。 他把錢還存在人家那邊,那不是給人家提供方便嗎? 人回來就沒事了吧? 人是沒事了,可是錢的問題得解決呀。 錢的問題? 是呀。你投進去的三十萬,那是毒資,沒收了,不會給你了。這裏不是還有馬軍的十四萬呢嗎? 到底是十四萬還是二十萬? 這個事也說清楚了,不是二十萬,是十四萬,就是他買機器剩下的那十四萬塊錢。 </s></s> 那怎麼出來個二十萬?</s>	surprise	surprise
<s> 是,弄得我們也挺緊張,怎麼還來個涉毒呢?根本不可能的事嘛! 這事對馬軍是個教訓,任何時候都不要拖欠公款。 他把錢還存在人家那邊,那不是給人家提供方便嗎? 人回來就沒事了吧? 人是沒事了,可是錢的問題得解決呀。 錢的問題? 是呀。你投進去的三十萬,那是毒資,沒收了,不會給你了。這裏不是還有馬軍的十四萬呢嗎? 到底是十四萬還是二十萬? 這個事也說清楚了,不是二十萬,是十四萬,就是他買機器剩下的那十四萬塊錢。 那怎麼出來個二十萬? </s></s> “是那個廠長使壞,往馬軍身上栽贓。事實是在買那兩臺機器的過程中,廠長還賺了十萬塊錢呢。他跟公安局交代的時候,把自己賺的這十萬塊錢也算在馬軍頭上了,這馬軍不就成二十四萬了嗎?他以爲這樣可以減輕一點他自己的罪過。</s>	angry	angry
<s></s></s> 事實上馬軍佔十四萬,他佔十六萬,總共三十萬。</s>	neutral	neutral
<s> 事實上馬軍佔十四萬,他佔十六萬,總共三十萬。 </s></s> 對了!</s>	joy	surprise
<s> 事實上馬軍佔十四萬,他佔十六萬,總共三十萬。 對了! </s></s> 這小子,夠壞的!</s>	angry	angry
<s> 事實上馬軍佔十四萬,他佔十六萬,總共三十萬。 對了! 這小子,夠壞的! </s></s> 要不說年輕人沒經驗呢。馬軍你要買印刷機,上哪兒買不來,非找他幹啥?</s>	disgust	disgust
<s> 事實上馬軍佔十四萬,他佔十六萬,總共三十萬。 對了! 這小子,夠壞的! 要不說年輕人沒經驗呢。馬軍你要買印刷機,上哪兒買不來,非找他幹啥? </s></s> 這件事還虧得你們局裏一個人來給說清楚了,要不馬軍還得背黑鍋呢。</s>	angry	joy
<s> 事實上馬軍佔十四萬,他佔十六萬,總共三十萬。 對了! 這小子,夠壞的! 要不說年輕人沒經驗呢。馬軍你要買印刷機,上哪兒買不來,非找他幹啥? 這件事還虧得你們局裏一個人來給說清楚了,要不馬軍還得背黑鍋呢。 </s></s> 局裏的人怎麼給說清楚了?</s>	surprise	surprise
<s> 事實上馬軍佔十四萬,他佔十六萬,總共三十萬。 對了! 這小子,夠壞的! 要不說年輕人沒經驗呢。馬軍你要買印刷機,上哪兒買不來,非找他幹啥? 這件事還虧得你們局裏一個人來給說清楚了,要不馬軍還得背黑鍋呢。 局裏的人怎麼給說清楚了? </s></s> 局裏有個人到我們那舉報,說馬軍買印刷機的時候向局裏報假帳,明明花了七十六萬,他用假發票報了八十六萬,自己貪污了十萬塊錢。我們把這個情況通報給哈爾濱警方。經哈爾濱警方詢問廠長,廠長才講了真實情況。</s>	neutral	joy
<s> 事實上馬軍佔十四萬,他佔十六萬,總共三十萬。 對了! 這小子,夠壞的! 要不說年輕人沒經驗呢。馬軍你要買印刷機,上哪兒買不來,非找他幹啥? 這件事還虧得你們局裏一個人來給說清楚了,要不馬軍還得背黑鍋呢。 局裏的人怎麼給說清楚了? 局裏有個人到我們那舉報,說馬軍買印刷機的時候向局裏報假帳,明明花了七十六萬,他用假發票報了八十六萬,自己貪污了十萬塊錢。我們把這個情況通報給哈爾濱警方。經哈爾濱警方詢問廠長,廠長才講了真實情況。 </s></s> 好啊,感謝警方做的工作。</s>	joy	joy
<s> 事實上馬軍佔十四萬,他佔十六萬,總共三十萬。 對了! 這小子,夠壞的! 要不說年輕人沒經驗呢。馬軍你要買印刷機,上哪兒買不來,非找他幹啥? 這件事還虧得你們局裏一個人來給說清楚了,要不馬軍還得背黑鍋呢。 局裏的人怎麼給說清楚了? 局裏有個人到我們那舉報,說馬軍買印刷機的時候向局裏報假帳,明明花了七十六萬,他用假發票報了八十六萬,自己貪污了十萬塊錢。我們把這個情況通報給哈爾濱警方。經哈爾濱警方詢問廠長,廠長才講了真實情況。 好啊,感謝警方做的工作。 </s></s> 沒什麼,應該的,下一步馬軍得想辦法還錢了。</s>	neutral	fear
<s> 事實上馬軍佔十四萬,他佔十六萬,總共三十萬。 對了! 這小子,夠壞的! 要不說年輕人沒經驗呢。馬軍你要買印刷機,上哪兒買不來,非找他幹啥? 這件事還虧得你們局裏一個人來給說清楚了,要不馬軍還得背黑鍋呢。 局裏的人怎麼給說清楚了? 局裏有個人到我們那舉報,說馬軍買印刷機的時候向局裏報假帳,明明花了七十六萬,他用假發票報了八十六萬,自己貪污了十萬塊錢。我們把這個情況通報給哈爾濱警方。經哈爾濱警方詢問廠長,廠長才講了真實情況。 好啊,感謝警方做的工作。 沒什麼,應該的,下一步馬軍得想辦法還錢了。 </s></s> 十四萬塊錢買個教訓,慢慢還吧。</s>	joy	neutral
<s> 事實上馬軍佔十四萬,他佔十六萬,總共三十萬。 對了! 這小子,夠壞的! 要不說年輕人沒經驗呢。馬軍你要買印刷機,上哪兒買不來,非找他幹啥? 這件事還虧得你們局裏一個人來給說清楚了,要不馬軍還得背黑鍋呢。 局裏的人怎麼給說清楚了? 局裏有個人到我們那舉報,說馬軍買印刷機的時候向局裏報假帳,明明花了七十六萬,他用假發票報了八十六萬,自己貪污了十萬塊錢。我們把這個情況通報給哈爾濱警方。經哈爾濱警方詢問廠長,廠長才講了真實情況。 好啊,感謝警方做的工作。 沒什麼,應該的,下一步馬軍得想辦法還錢了。 十四萬塊錢買個教訓,慢慢還吧。 </s></s> 馬總,還不能慢慢還,得趕緊還,不能超過三個月。</s>	fear	fear
<s> 對了! 這小子,夠壞的! 要不說年輕人沒經驗呢。馬軍你要買印刷機,上哪兒買不來,非找他幹啥? 這件事還虧得你們局裏一個人來給說清楚了,要不馬軍還得背黑鍋呢。 局裏的人怎麼給說清楚了? 局裏有個人到我們那舉報,說馬軍買印刷機的時候向局裏報假帳,明明花了七十六萬,他用假發票報了八十六萬,自己貪污了十萬塊錢。我們把這個情況通報給哈爾濱警方。經哈爾濱警方詢問廠長,廠長才講了真實情況。 好啊,感謝警方做的工作。 沒什麼,應該的,下一步馬軍得想辦法還錢了。 十四萬塊錢買個教訓,慢慢還吧。 馬總,還不能慢慢還,得趕緊還,不能超過三個月。 </s></s> 爲什麼?</s>	surprise	surprise
<s> 這小子,夠壞的! 要不說年輕人沒經驗呢。馬軍你要買印刷機,上哪兒買不來,非找他幹啥? 這件事還虧得你們局裏一個人來給說清楚了,要不馬軍還得背黑鍋呢。 局裏的人怎麼給說清楚了? 局裏有個人到我們那舉報,說馬軍買印刷機的時候向局裏報假帳,明明花了七十六萬,他用假發票報了八十六萬,自己貪污了十萬塊錢。我們把這個情況通報給哈爾濱警方。經哈爾濱警方詢問廠長,廠長才講了真實情況。 好啊,感謝警方做的工作。 沒什麼,應該的,下一步馬軍得想辦法還錢了。 十四萬塊錢買個教訓,慢慢還吧。 馬總,還不能慢慢還,得趕緊還,不能超過三個月。 爲什麼? </s></s> 你想呀,他欠的那筆錢,如果就在帳上掛着也就掛着了,慢慢還也行。可現在被動用了,也就是被挪用了。挪用了三個月不還,那就構成挪用公款罪了,那可是上了刑法的。</s>	angry	fear
<s> 要不說年輕人沒經驗呢。馬軍你要買印刷機,上哪兒買不來,非找他幹啥? 這件事還虧得你們局裏一個人來給說清楚了,要不馬軍還得背黑鍋呢。 局裏的人怎麼給說清楚了? 局裏有個人到我們那舉報,說馬軍買印刷機的時候向局裏報假帳,明明花了七十六萬,他用假發票報了八十六萬,自己貪污了十萬塊錢。我們把這個情況通報給哈爾濱警方。經哈爾濱警方詢問廠長,廠長才講了真實情況。 好啊,感謝警方做的工作。 沒什麼,應該的,下一步馬軍得想辦法還錢了。 十四萬塊錢買個教訓,慢慢還吧。 馬總,還不能慢慢還,得趕緊還,不能超過三個月。 爲什麼? 你想呀,他欠的那筆錢,如果就在帳上掛着也就掛着了,慢慢還也行。可現在被動用了,也就是被挪用了。挪用了三個月不還,那就構成挪用公款罪了,那可是上了刑法的。 </s></s> 還構成犯罪了?</s>	angry	surprise
<s> 這件事還虧得你們局裏一個人來給說清楚了,要不馬軍還得背黑鍋呢。 局裏的人怎麼給說清楚了? 局裏有個人到我們那舉報,說馬軍買印刷機的時候向局裏報假帳,明明花了七十六萬,他用假發票報了八十六萬,自己貪污了十萬塊錢。我們把這個情況通報給哈爾濱警方。經哈爾濱警方詢問廠長,廠長才講了真實情況。 好啊,感謝警方做的工作。 沒什麼,應該的,下一步馬軍得想辦法還錢了。 十四萬塊錢買個教訓,慢慢還吧。 馬總,還不能慢慢還,得趕緊還,不能超過三個月。 爲什麼? 你想呀,他欠的那筆錢,如果就在帳上掛着也就掛着了,慢慢還也行。可現在被動用了,也就是被挪用了。挪用了三個月不還,那就構成挪用公款罪了,那可是上了刑法的。 還構成犯罪了? </s></s> 那可不!</s>	surprise	fear
<s> 局裏的人怎麼給說清楚了? 局裏有個人到我們那舉報,說馬軍買印刷機的時候向局裏報假帳,明明花了七十六萬,他用假發票報了八十六萬,自己貪污了十萬塊錢。我們把這個情況通報給哈爾濱警方。經哈爾濱警方詢問廠長,廠長才講了真實情況。 好啊,感謝警方做的工作。 沒什麼,應該的,下一步馬軍得想辦法還錢了。 十四萬塊錢買個教訓,慢慢還吧。 馬總,還不能慢慢還,得趕緊還,不能超過三個月。 爲什麼? 你想呀,他欠的那筆錢,如果就在帳上掛着也就掛着了,慢慢還也行。可現在被動用了,也就是被挪用了。挪用了三個月不還,那就構成挪用公款罪了,那可是上了刑法的。 還構成犯罪了? 那可不! </s></s> 是的,馬總,刑法就是這樣規定的。幸虧那件事他是被動的,不用負什麼責任,但錢是回不來了。</s>	neutral	neutral
<s> 局裏有個人到我們那舉報,說馬軍買印刷機的時候向局裏報假帳,明明花了七十六萬,他用假發票報了八十六萬,自己貪污了十萬塊錢。我們把這個情況通報給哈爾濱警方。經哈爾濱警方詢問廠長,廠長才講了真實情況。 好啊,感謝警方做的工作。 沒什麼,應該的,下一步馬軍得想辦法還錢了。 十四萬塊錢買個教訓,慢慢還吧。 馬總,還不能慢慢還,得趕緊還,不能超過三個月。 爲什麼? 你想呀,他欠的那筆錢,如果就在帳上掛着也就掛着了,慢慢還也行。可現在被動用了,也就是被挪用了。挪用了三個月不還,那就構成挪用公款罪了,那可是上了刑法的。 還構成犯罪了? 那可不! 是的,馬總,刑法就是這樣規定的。幸虧那件事他是被動的,不用負什麼責任,但錢是回不來了。 </s></s> 好吧,那就想辦法還吧。</s>	neutral	neutral
<s> 好啊,感謝警方做的工作。 沒什麼,應該的,下一步馬軍得想辦法還錢了。 十四萬塊錢買個教訓,慢慢還吧。 馬總,還不能慢慢還,得趕緊還,不能超過三個月。 爲什麼? 你想呀,他欠的那筆錢,如果就在帳上掛着也就掛着了,慢慢還也行。可現在被動用了,也就是被挪用了。挪用了三個月不還,那就構成挪用公款罪了,那可是上了刑法的。 還構成犯罪了? 那可不! 是的,馬總,刑法就是這樣規定的。幸虧那件事他是被動的,不用負什麼責任,但錢是回不來了。 好吧,那就想辦法還吧。 </s></s> 馬總忙吧,不打擾了。</s>	neutral	neutral
<s></s></s> 韓東!</s>	joy	surprise
<s> 韓東! </s></s> 馬軍!你回來了?</s>	surprise	joy
<s> 韓東! 馬軍!你回來了? </s></s> 回來了。</s>	neutral	joy
<s> 韓東! 馬軍!你回來了? 回來了。 </s></s> 就你自個兒?</s>	surprise	surprise
<s> 韓東! 馬軍!你回來了? 回來了。 就你自個兒? </s></s> “</s>	neutral	neutral
<s></s></s> 沒事兒了?</s>	surprise	surprise
<s> 沒事兒了? </s></s> 沒事兒了。</s>	neutral	joy
<s> 沒事兒了? 沒事兒了。 </s></s> 太好了!回家吧?</s>	joy	joy
<s> 沒事兒了? 沒事兒了。 太好了!回家吧? </s></s> 回家!</s>	joy	joy
<s> 沒事兒了? 沒事兒了。 太好了!回家吧? 回家! </s></s> 走!上車!</s>	joy	joy
<s></s></s> 你走了幾天?</s>	surprise	surprise
<s> 你走了幾天? </s></s> 幾天?昨天去的,今天回來了。</s>	surprise	surprise
<s> 你走了幾天? 幾天?昨天去的,今天回來了。 </s></s> 好像走了好幾天似的。真的沒事兒了?</s>	surprise	fear
<s> 你走了幾天? 幾天?昨天去的,今天回來了。 好像走了好幾天似的。真的沒事兒了? </s></s> 沒事兒了,我的車票都是他們給買的。</s>	neutral	joy
<s> 你走了幾天? 幾天?昨天去的,今天回來了。 好像走了好幾天似的。真的沒事兒了? 沒事兒了,我的車票都是他們給買的。 </s></s> 那到底叫你去幹啥?</s>	surprise	fear
<s> 你走了幾天? 幾天?昨天去的,今天回來了。 好像走了好幾天似的。真的沒事兒了? 沒事兒了,我的車票都是他們給買的。 那到底叫你去幹啥? </s></s> 哈爾濱那個印刷廠的廠長嘛!我買印刷機剩了點錢在他哪兒。我說這是借的公款,暫時不用還,你可以利用這段時間想辦法給我掙點錢。他說買股票,我說行。結果他沒買股票,投資給了一個什麼公司,沒想到那個公司是假的,其實是販毒的,這不就沾包兒了?</s>	angry	angry
<s> 你走了幾天? 幾天?昨天去的,今天回來了。 好像走了好幾天似的。真的沒事兒了? 沒事兒了,我的車票都是他們給買的。 那到底叫你去幹啥? 哈爾濱那個印刷廠的廠長嘛!我買印刷機剩了點錢在他哪兒。我說這是借的公款,暫時不用還,你可以利用這段時間想辦法給我掙點錢。他說買股票,我說行。結果他沒買股票,投資給了一個什麼公司,沒想到那個公司是假的,其實是販毒的,這不就沾包兒了? </s></s> 不知道嘛,說清楚就行了唄。</s>	neutral	joy
<s> 你走了幾天? 幾天?昨天去的,今天回來了。 好像走了好幾天似的。真的沒事兒了? 沒事兒了,我的車票都是他們給買的。 那到底叫你去幹啥? 哈爾濱那個印刷廠的廠長嘛!我買印刷機剩了點錢在他哪兒。我說這是借的公款,暫時不用還,你可以利用這段時間想辦法給我掙點錢。他說買股票,我說行。結果他沒買股票,投資給了一個什麼公司,沒想到那個公司是假的,其實是販毒的,這不就沾包兒了? 不知道嘛,說清楚就行了唄。 </s></s> 是,說清楚就沒事了,廠長也是受騙的。</s>	neutral	joy
<s> 你走了幾天? 幾天?昨天去的,今天回來了。 好像走了好幾天似的。真的沒事兒了? 沒事兒了,我的車票都是他們給買的。 那到底叫你去幹啥? 哈爾濱那個印刷廠的廠長嘛!我買印刷機剩了點錢在他哪兒。我說這是借的公款,暫時不用還,你可以利用這段時間想辦法給我掙點錢。他說買股票,我說行。結果他沒買股票,投資給了一個什麼公司,沒想到那個公司是假的,其實是販毒的,這不就沾包兒了? 不知道嘛,說清楚就行了唄。 是,說清楚就沒事了,廠長也是受騙的。 </s></s> 廠長也沒事了?</s>	surprise	surprise
<s> 你走了幾天? 幾天?昨天去的,今天回來了。 好像走了好幾天似的。真的沒事兒了? 沒事兒了,我的車票都是他們給買的。 那到底叫你去幹啥? 哈爾濱那個印刷廠的廠長嘛!我買印刷機剩了點錢在他哪兒。我說這是借的公款,暫時不用還,你可以利用這段時間想辦法給我掙點錢。他說買股票,我說行。結果他沒買股票,投資給了一個什麼公司,沒想到那個公司是假的,其實是販毒的,這不就沾包兒了? 不知道嘛,說清楚就行了唄。 是,說清楚就沒事了,廠長也是受騙的。 廠長也沒事了? </s></s> 沒事了,他也回去了,就是錢回不來了。</s>	neutral	neutral
<s> 你走了幾天? 幾天?昨天去的,今天回來了。 好像走了好幾天似的。真的沒事兒了? 沒事兒了,我的車票都是他們給買的。 那到底叫你去幹啥? 哈爾濱那個印刷廠的廠長嘛!我買印刷機剩了點錢在他哪兒。我說這是借的公款,暫時不用還,你可以利用這段時間想辦法給我掙點錢。他說買股票,我說行。結果他沒買股票,投資給了一個什麼公司,沒想到那個公司是假的,其實是販毒的,這不就沾包兒了? 不知道嘛,說清楚就行了唄。 是,說清楚就沒事了,廠長也是受騙的。 廠長也沒事了? 沒事了,他也回去了,就是錢回不來了。 </s></s> 你那份錢廠長應該給你賠!</s>	neutral	angry
<s> 幾天?昨天去的,今天回來了。 好像走了好幾天似的。真的沒事兒了? 沒事兒了,我的車票都是他們給買的。 那到底叫你去幹啥? 哈爾濱那個印刷廠的廠長嘛!我買印刷機剩了點錢在他哪兒。我說這是借的公款,暫時不用還,你可以利用這段時間想辦法給我掙點錢。他說買股票,我說行。結果他沒買股票,投資給了一個什麼公司,沒想到那個公司是假的,其實是販毒的,這不就沾包兒了? 不知道嘛,說清楚就行了唄。 是,說清楚就沒事了,廠長也是受騙的。 廠長也沒事了? 沒事了,他也回去了,就是錢回不來了。 你那份錢廠長應該給你賠! </s></s> 唉,他也沒想到弄成這樣,也怪我,不該把錢存在他那兒。</s>	sadness	sadness
<s> 好像走了好幾天似的。真的沒事兒了? 沒事兒了,我的車票都是他們給買的。 那到底叫你去幹啥? 哈爾濱那個印刷廠的廠長嘛!我買印刷機剩了點錢在他哪兒。我說這是借的公款,暫時不用還,你可以利用這段時間想辦法給我掙點錢。他說買股票,我說行。結果他沒買股票,投資給了一個什麼公司,沒想到那個公司是假的,其實是販毒的,這不就沾包兒了? 不知道嘛,說清楚就行了唄。 是,說清楚就沒事了,廠長也是受騙的。 廠長也沒事了? 沒事了,他也回去了,就是錢回不來了。 你那份錢廠長應該給你賠! 唉,他也沒想到弄成這樣,也怪我,不該把錢存在他那兒。 </s></s> 對。</s>	neutral	neutral
<s></s></s> 快回去吧,可能把你爸媽急得夠<unk>。</s>	fear	joy
<s> 快回去吧,可能把你爸媽急得夠<unk>。 </s></s> 沒事兒!你告訴曉華姐,明天上青河。</s>	neutral	joy
<s> 快回去吧,可能把你爸媽急得夠<unk>。 沒事兒!你告訴曉華姐,明天上青河。 </s></s> 好吧。</s>	neutral	joy
<s></s></s> 小姐,我想見見韓國來的客人韓美玉,你能跟她說請她下來一下嗎?</s>	neutral	surprise
<s> 小姐,我想見見韓國來的客人韓美玉,你能跟她說請她下來一下嗎? </s></s> 可以。請問您怎麼稱呼?</s>	neutral	joy
<s> 小姐,我想見見韓國來的客人韓美玉,你能跟她說請她下來一下嗎? 可以。請問您怎麼稱呼? </s></s> 我姓韓,叫韓東。</s>	joy	neutral
<s> 小姐,我想見見韓國來的客人韓美玉,你能跟她說請她下來一下嗎? 可以。請問您怎麼稱呼? 我姓韓,叫韓東。 </s></s> 好的,請稍等。</s>	neutral	neutral
<s></s></s> 請問韓美玉小姐在嗎?......是這樣,有一位先生想要和您見面,您能下來一下嗎?......他叫韓東,......他就在樓下大堂......好的......她下來了。</s>	joy	neutral
<s> 請問韓美玉小姐在嗎?......是這樣,有一位先生想要和您見面,您能下來一下嗎?......他叫韓東,......他就在樓下大堂......好的......她下來了。 </s></s> 謝謝。</s>	neutral	neutral
<s></s></s> 韓東!你來了。</s>	joy	joy
<s> 韓東!你來了。 </s></s> 美玉!咱們出去一下。</s>	joy	joy
<s> 韓東!你來了。 美玉!咱們出去一下。 </s></s> 好的,上哪兒?</s>	joy	surprise
<s></s></s> 要不要跟大爺說一聲?</s>	fear	fear
<s> 要不要跟大爺說一聲? </s></s> 不用。我說是你來了,我們可能要出去一下。</s>	neutral	joy
<s></s></s> 咱們去看看馬軍。</s>	joy	neutral
<s> 咱們去看看馬軍。 </s></s> 馬軍回來了?</s>	surprise	surprise
<s></s></s> 回來了,我昨天在車站正好接到他。</s>	neutral	joy
<s> 回來了,我昨天在車站正好接到他。 </s></s> 他現在在哪兒?</s>	surprise	surprise
<s></s></s> 對,公司不能賣,這是唯一能掙錢的辦法,不但不賣,還得想辦法把生意作大,多掙錢。</s>	neutral	fear
<s> 對,公司不能賣,這是唯一能掙錢的辦法,不但不賣,還得想辦法把生意作大,多掙錢。 </s></s> 那就想想怎麼多掙錢吧。</s>	neutral	fear
<s></s></s> 馬軍是咱們家的孩子,咱們得幫他。</s>	neutral	neutral
<s> 馬軍是咱們家的孩子,咱們得幫他。 </s></s> 是。</s>	neutral	neutral
<s> 馬軍是咱們家的孩子,咱們得幫他。 是。 </s></s> 我想把咱們那個廠賣了。</s>	neutral	neutral
<s> 馬軍是咱們家的孩子,咱們得幫他。 是。 我想把咱們那個廠賣了。 </s></s> 把咱們那個廠賣了?</s>	surprise	surprise
<s> 馬軍是咱們家的孩子,咱們得幫他。 是。 我想把咱們那個廠賣了。 把咱們那個廠賣了? </s></s> 是,把咱們那個廠賣了。我現在也幹不了什麼活了,該休息,養老了。</s>	sadness	sadness
<s> 馬軍是咱們家的孩子,咱們得幫他。 是。 我想把咱們那個廠賣了。 把咱們那個廠賣了? 是,把咱們那個廠賣了。我現在也幹不了什麼活了,該休息,養老了。 </s></s> 您要想好,這是您多年辛苦的結晶。</s>	neutral	fear
<s> 馬軍是咱們家的孩子,咱們得幫他。 是。 我想把咱們那個廠賣了。 把咱們那個廠賣了? 是,把咱們那個廠賣了。我現在也幹不了什麼活了,該休息,養老了。 您要想好,這是您多年辛苦的結晶。 </s></s> 我早就想賣了,沒來之前我就想過。來了以後看見韓東,想讓韓東過去替我管。後來你不是說馬軍也想去幫我管廠嗎?其實那都不現實,他們誰也出不去。現在正好是個機會,把廠賣了,幫馬軍度過難關,也算幫他們家裏一個忙。</s>	joy	neutral
<s> 馬軍是咱們家的孩子,咱們得幫他。 是。 我想把咱們那個廠賣了。 把咱們那個廠賣了? 是,把咱們那個廠賣了。我現在也幹不了什麼活了,該休息,養老了。 您要想好,這是您多年辛苦的結晶。 我早就想賣了,沒來之前我就想過。來了以後看見韓東,想讓韓東過去替我管。後來你不是說馬軍也想去幫我管廠嗎?其實那都不現實,他們誰也出不去。現在正好是個機會,把廠賣了,幫馬軍度過難關,也算幫他們家裏一個忙。 </s></s> 對,這是個好主意。</s>	joy	joy
<s> 馬軍是咱們家的孩子,咱們得幫他。 是。 我想把咱們那個廠賣了。 把咱們那個廠賣了? 是,把咱們那個廠賣了。我現在也幹不了什麼活了,該休息,養老了。 您要想好,這是您多年辛苦的結晶。 我早就想賣了,沒來之前我就想過。來了以後看見韓東,想讓韓東過去替我管。後來你不是說馬軍也想去幫我管廠嗎?其實那都不現實,他們誰也出不去。現在正好是個機會,把廠賣了,幫馬軍度過難關,也算幫他們家裏一個忙。 對,這是個好主意。 </s></s> 咱們去打電話吧?</s>	neutral	neutral
<s> 馬軍是咱們家的孩子,咱們得幫他。 是。 我想把咱們那個廠賣了。 把咱們那個廠賣了? 是,把咱們那個廠賣了。我現在也幹不了什麼活了,該休息,養老了。 您要想好,這是您多年辛苦的結晶。 我早就想賣了,沒來之前我就想過。來了以後看見韓東,想讓韓東過去替我管。後來你不是說馬軍也想去幫我管廠嗎?其實那都不現實,他們誰也出不去。現在正好是個機會,把廠賣了,幫馬軍度過難關,也算幫他們家裏一個忙。 對,這是個好主意。 咱們去打電話吧? </s></s> 現在就去嗎?</s>	neutral	surprise
<s> 馬軍是咱們家的孩子,咱們得幫他。 是。 我想把咱們那個廠賣了。 把咱們那個廠賣了? 是,把咱們那個廠賣了。我現在也幹不了什麼活了,該休息,養老了。 您要想好,這是您多年辛苦的結晶。 我早就想賣了,沒來之前我就想過。來了以後看見韓東,想讓韓東過去替我管。後來你不是說馬軍也想去幫我管廠嗎?其實那都不現實,他們誰也出不去。現在正好是個機會,把廠賣了,幫馬軍度過難關,也算幫他們家裏一個忙。 對,這是個好主意。 咱們去打電話吧? 現在就去嗎? </s></s> 就去吧,他們不是用錢很急嗎?</s>	neutral	surprise
<s> 是。 我想把咱們那個廠賣了。 把咱們那個廠賣了? 是,把咱們那個廠賣了。我現在也幹不了什麼活了,該休息,養老了。 您要想好,這是您多年辛苦的結晶。 我早就想賣了,沒來之前我就想過。來了以後看見韓東,想讓韓東過去替我管。後來你不是說馬軍也想去幫我管廠嗎?其實那都不現實,他們誰也出不去。現在正好是個機會,把廠賣了,幫馬軍度過難關,也算幫他們家裏一個忙。 對,這是個好主意。 咱們去打電話吧? 現在就去嗎? 就去吧,他們不是用錢很急嗎? </s></s> 好吧。</s>	neutral	neutral
<s></s></s> 請進!</s>	neutral	neutral
<s> 請進! </s></s> 唐局長!</s>	surprise	neutral
<s> 請進! 唐局長! </s></s> 馬總!你怎麼有時間過來?</s>	surprise	surprise
<s> 請進! 唐局長! 馬總!你怎麼有時間過來? </s></s> 有件事情向你彙報。</s>	neutral	neutral
<s> 請進! 唐局長! 馬總!你怎麼有時間過來? 有件事情向你彙報。 </s></s> 請坐!有什麼大事了?</s>	surprise	surprise
<s> 請進! 唐局長! 馬總!你怎麼有時間過來? 有件事情向你彙報。 請坐!有什麼大事了? </s></s> 也不算大事,可是對我家裏來說就是大事了。</s>	neutral	sadness
<s> 請進! 唐局長! 馬總!你怎麼有時間過來? 有件事情向你彙報。 請坐!有什麼大事了? 也不算大事,可是對我家裏來說就是大事了。 </s></s> 家裏的事還要跟我說嗎?</s>	neutral	surprise
<s> 請進! 唐局長! 馬總!你怎麼有時間過來? 有件事情向你彙報。 請坐!有什麼大事了? 也不算大事,可是對我家裏來說就是大事了。 家裏的事還要跟我說嗎? </s></s> 是的,是要說說。</s>	neutral	sadness
<s> 請進! 唐局長! 馬總!你怎麼有時間過來? 有件事情向你彙報。 請坐!有什麼大事了? 也不算大事,可是對我家裏來說就是大事了。 家裏的事還要跟我說嗎? 是的,是要說說。 </s></s> 怎麼了?什麼事?</s>	surprise	surprise
<s> 請進! 唐局長! 馬總!你怎麼有時間過來? 有件事情向你彙報。 請坐!有什麼大事了? 也不算大事,可是對我家裏來說就是大事了。 家裏的事還要跟我說嗎? 是的,是要說說。 怎麼了?什麼事? </s></s> 我那個兒子,馬軍,節前在印刷廠上班的時候,經手從哈爾濱買了兩臺印刷機,這事你可能知道了。買機器剩下了十四萬塊錢,暫時存在哈爾濱那個印刷廠,結果被那個廠長給動用了。動用了還不要緊,他是稀裏糊塗投給了一個販毒團伙。那個團伙一抓,就把那個廠長和馬軍都牽林去了。馬軍還被叫到哈爾濱去了兩天,去給說清楚。現在事情是過去了,涉毒的事是沒有了,可錢是回不來了。十四萬塊錢,對於一個家庭來說可不是個小數目。我的意思是說,這錢我可能不會在短時間還上。</s>	neutral	fear
<s> 請進! 唐局長! 馬總!你怎麼有時間過來? 有件事情向你彙報。 請坐!有什麼大事了? 也不算大事,可是對我家裏來說就是大事了。 家裏的事還要跟我說嗎? 是的,是要說說。 怎麼了?什麼事? 我那個兒子,馬軍,節前在印刷廠上班的時候,經手從哈爾濱買了兩臺印刷機,這事你可能知道了。買機器剩下了十四萬塊錢,暫時存在哈爾濱那個印刷廠,結果被那個廠長給動用了。動用了還不要緊,他是稀裏糊塗投給了一個販毒團伙。那個團伙一抓,就把那個廠長和馬軍都牽林去了。馬軍還被叫到哈爾濱去了兩天,去給說清楚。現在事情是過去了,涉毒的事是沒有了,可錢是回不來了。十四萬塊錢,對於一個家庭來說可不是個小數目。我的意思是說,這錢我可能不會在短時間還上。 </s></s> 有什麼需要幫忙的嗎?</s>	surprise	surprise
<s> 唐局長! 馬總!你怎麼有時間過來? 有件事情向你彙報。 請坐!有什麼大事了? 也不算大事,可是對我家裏來說就是大事了。 家裏的事還要跟我說嗎? 是的,是要說說。 怎麼了?什麼事? 我那個兒子,馬軍,節前在印刷廠上班的時候,經手從哈爾濱買了兩臺印刷機,這事你可能知道了。買機器剩下了十四萬塊錢,暫時存在哈爾濱那個印刷廠,結果被那個廠長給動用了。動用了還不要緊,他是稀裏糊塗投給了一個販毒團伙。那個團伙一抓,就把那個廠長和馬軍都牽林去了。馬軍還被叫到哈爾濱去了兩天,去給說清楚。現在事情是過去了,涉毒的事是沒有了,可錢是回不來了。十四萬塊錢,對於一個家庭來說可不是個小數目。我的意思是說,這錢我可能不會在短時間還上。 有什麼需要幫忙的嗎? </s></s> 不不,我不是向組織伸手。我就是向組織彙報一下。我會想一切辦法還錢的。因爲錢數比較大,可能在今年之內還不清了。</s>	neutral	fear
<s> 馬總!你怎麼有時間過來? 有件事情向你彙報。 請坐!有什麼大事了? 也不算大事,可是對我家裏來說就是大事了。 家裏的事還要跟我說嗎? 是的,是要說說。 怎麼了?什麼事? 我那個兒子,馬軍,節前在印刷廠上班的時候,經手從哈爾濱買了兩臺印刷機,這事你可能知道了。買機器剩下了十四萬塊錢,暫時存在哈爾濱那個印刷廠,結果被那個廠長給動用了。動用了還不要緊,他是稀裏糊塗投給了一個販毒團伙。那個團伙一抓,就把那個廠長和馬軍都牽林去了。馬軍還被叫到哈爾濱去了兩天,去給說清楚。現在事情是過去了,涉毒的事是沒有了,可錢是回不來了。十四萬塊錢,對於一個家庭來說可不是個小數目。我的意思是說,這錢我可能不會在短時間還上。 有什麼需要幫忙的嗎? 不不,我不是向組織伸手。我就是向組織彙報一下。我會想一切辦法還錢的。因爲錢數比較大,可能在今年之內還不清了。 </s></s> 我是要求過,年底前要把一切應還的欠款還清,包括馬軍的這筆錢。既然出現了這種情況,那就特殊問題特殊對待吧。</s>	neutral	neutral
<s> 有件事情向你彙報。 請坐!有什麼大事了? 也不算大事,可是對我家裏來說就是大事了。 家裏的事還要跟我說嗎? 是的,是要說說。 怎麼了?什麼事? 我那個兒子,馬軍,節前在印刷廠上班的時候,經手從哈爾濱買了兩臺印刷機,這事你可能知道了。買機器剩下了十四萬塊錢,暫時存在哈爾濱那個印刷廠,結果被那個廠長給動用了。動用了還不要緊,他是稀裏糊塗投給了一個販毒團伙。那個團伙一抓,就把那個廠長和馬軍都牽林去了。馬軍還被叫到哈爾濱去了兩天,去給說清楚。現在事情是過去了,涉毒的事是沒有了,可錢是回不來了。十四萬塊錢,對於一個家庭來說可不是個小數目。我的意思是說,這錢我可能不會在短時間還上。 有什麼需要幫忙的嗎? 不不,我不是向組織伸手。我就是向組織彙報一下。我會想一切辦法還錢的。因爲錢數比較大,可能在今年之內還不清了。 我是要求過,年底前要把一切應還的欠款還清,包括馬軍的這筆錢。既然出現了這種情況,那就特殊問題特殊對待吧。 </s></s> 還有一個問題。馬軍的這筆錢,現在被動用了,是屬於挪用公款了。我最近聽說,挪用公款三個月之內不歸還的話,就構成挪用公款罪了。這筆錢我在三個月之內是肯定還不清的。我上哪去弄這麼多錢呀?到時候我真得吃官司了!</s>	angry	fear
<s> 請坐!有什麼大事了? 也不算大事,可是對我家裏來說就是大事了。 家裏的事還要跟我說嗎? 是的,是要說說。 怎麼了?什麼事? 我那個兒子,馬軍,節前在印刷廠上班的時候,經手從哈爾濱買了兩臺印刷機,這事你可能知道了。買機器剩下了十四萬塊錢,暫時存在哈爾濱那個印刷廠,結果被那個廠長給動用了。動用了還不要緊,他是稀裏糊塗投給了一個販毒團伙。那個團伙一抓,就把那個廠長和馬軍都牽林去了。馬軍還被叫到哈爾濱去了兩天,去給說清楚。現在事情是過去了,涉毒的事是沒有了,可錢是回不來了。十四萬塊錢,對於一個家庭來說可不是個小數目。我的意思是說,這錢我可能不會在短時間還上。 有什麼需要幫忙的嗎? 不不,我不是向組織伸手。我就是向組織彙報一下。我會想一切辦法還錢的。因爲錢數比較大,可能在今年之內還不清了。 我是要求過,年底前要把一切應還的欠款還清,包括馬軍的這筆錢。既然出現了這種情況,那就特殊問題特殊對待吧。 還有一個問題。馬軍的這筆錢,現在被動用了,是屬於挪用公款了。我最近聽說,挪用公款三個月之內不歸還的話,就構成挪用公款罪了。這筆錢我在三個月之內是肯定還不清的。我上哪去弄這麼多錢呀?到時候我真得吃官司了! </s></s> “嗯,法律上是有這麼一條,挪用公款的,必須在三個月之內歸還,否則就構成犯罪。不過,他的問題並沒有進入司法程序,咱們用不着那麼較真,積極還款就是了。</s>	neutral	joy
<s></s></s> 打通了嗎?</s>	surprise	surprise
<s> 打通了嗎? </s></s> 通了。</s>	neutral	neutral
<s> 打通了嗎? 通了。 </s></s> 我姐在家嗎?</s>	surprise	surprise
<s> 打通了嗎? 通了。 我姐在家嗎? </s></s> 在家。</s>	neutral	neutral
<s> 打通了嗎? 通了。 我姐在家嗎? 在家。 </s></s> 她同意你賣廠子嗎?</s>	surprise	fear
<s> 打通了嗎? 通了。 我姐在家嗎? 在家。 她同意你賣廠子嗎? </s></s> 我把這邊的情況跟她說了,她很同意。</s>	joy	joy
<s> 打通了嗎? 通了。 我姐在家嗎? 在家。 她同意你賣廠子嗎? 我把這邊的情況跟她說了,她很同意。 </s></s> 也不知道能賣多少錢?</s>	sadness	fear
<s> 打通了嗎? 通了。 我姐在家嗎? 在家。 她同意你賣廠子嗎? 我把這邊的情況跟她說了,她很同意。 也不知道能賣多少錢? </s></s> 能賣多少就賣多少吧,一定要賣出去。</s>	angry	surprise
<s> 打通了嗎? 通了。 我姐在家嗎? 在家。 她同意你賣廠子嗎? 我把這邊的情況跟她說了,她很同意。 也不知道能賣多少錢? 能賣多少就賣多少吧,一定要賣出去。 </s></s> 她們家裏都挺好的嗎?</s>	joy	fear
<s> 打通了嗎? 通了。 我姐在家嗎? 在家。 她同意你賣廠子嗎? 我把這邊的情況跟她說了,她很同意。 也不知道能賣多少錢? 能賣多少就賣多少吧,一定要賣出去。 她們家裏都挺好的嗎? </s></s> 都挺好。她聽說你叔叔二十年前扔了一個孩子,現在又找回來了,是個大小夥子,非常高興。她說中國的事怎麼這麼有意思?就像是神話故事。</s>	joy	joy
<s> 打通了嗎? 通了。 我姐在家嗎? 在家。 她同意你賣廠子嗎? 我把這邊的情況跟她說了,她很同意。 也不知道能賣多少錢? 能賣多少就賣多少吧,一定要賣出去。 她們家裏都挺好的嗎? 都挺好。她聽說你叔叔二十年前扔了一個孩子,現在又找回來了,是個大小夥子,非常高興。她說中國的事怎麼這麼有意思?就像是神話故事。 </s></s> 她也想過來看看吧?</s>	joy	joy
<s> 通了。 我姐在家嗎? 在家。 她同意你賣廠子嗎? 我把這邊的情況跟她說了,她很同意。 也不知道能賣多少錢? 能賣多少就賣多少吧,一定要賣出去。 她們家裏都挺好的嗎? 都挺好。她聽說你叔叔二十年前扔了一個孩子,現在又找回來了,是個大小夥子,非常高興。她說中國的事怎麼這麼有意思?就像是神話故事。 她也想過來看看吧? </s></s> 是呀,她特別想看看這個撿回來的孩子是個什麼樣子,也想看看韓東,看看你二叔和二嬸。</s>	joy	joy
<s> 我姐在家嗎? 在家。 她同意你賣廠子嗎? 我把這邊的情況跟她說了,她很同意。 也不知道能賣多少錢? 能賣多少就賣多少吧,一定要賣出去。 她們家裏都挺好的嗎? 都挺好。她聽說你叔叔二十年前扔了一個孩子,現在又找回來了,是個大小夥子,非常高興。她說中國的事怎麼這麼有意思?就像是神話故事。 她也想過來看看吧? 是呀,她特別想看看這個撿回來的孩子是個什麼樣子,也想看看韓東,看看你二叔和二嬸。 </s></s> 下次一定讓她來。</s>	joy	joy
<s> 在家。 她同意你賣廠子嗎? 我把這邊的情況跟她說了,她很同意。 也不知道能賣多少錢? 能賣多少就賣多少吧,一定要賣出去。 她們家裏都挺好的嗎? 都挺好。她聽說你叔叔二十年前扔了一個孩子,現在又找回來了,是個大小夥子,非常高興。她說中國的事怎麼這麼有意思?就像是神話故事。 她也想過來看看吧? 是呀,她特別想看看這個撿回來的孩子是個什麼樣子,也想看看韓東,看看你二叔和二嬸。 下次一定讓她來。 </s></s> 行,下次你就能帶她來了。哦,還有,我跟你姐說,她往這邊匯款的時候,地址這樣寫:中國,黑龍江,景陽鎮,高麗屯,韓長波收,這樣寫行嗎?</s>	joy	fear
<s> 她同意你賣廠子嗎? 我把這邊的情況跟她說了,她很同意。 也不知道能賣多少錢? 能賣多少就賣多少吧,一定要賣出去。 她們家裏都挺好的嗎? 都挺好。她聽說你叔叔二十年前扔了一個孩子,現在又找回來了,是個大小夥子,非常高興。她說中國的事怎麼這麼有意思?就像是神話故事。 她也想過來看看吧? 是呀,她特別想看看這個撿回來的孩子是個什麼樣子,也想看看韓東,看看你二叔和二嬸。 下次一定讓她來。 行,下次你就能帶她來了。哦,還有,我跟你姐說,她往這邊匯款的時候,地址這樣寫:中國,黑龍江,景陽鎮,高麗屯,韓長波收,這樣寫行嗎? </s></s> 行,不過得寫清楚是轉給馬軍的。</s>	neutral	neutral
<s> 我把這邊的情況跟她說了,她很同意。 也不知道能賣多少錢? 能賣多少就賣多少吧,一定要賣出去。 她們家裏都挺好的嗎? 都挺好。她聽說你叔叔二十年前扔了一個孩子,現在又找回來了,是個大小夥子,非常高興。她說中國的事怎麼這麼有意思?就像是神話故事。 她也想過來看看吧? 是呀,她特別想看看這個撿回來的孩子是個什麼樣子,也想看看韓東,看看你二叔和二嬸。 下次一定讓她來。 行,下次你就能帶她來了。哦,還有,我跟你姐說,她往這邊匯款的時候,地址這樣寫:中國,黑龍江,景陽鎮,高麗屯,韓長波收,這樣寫行嗎? 行,不過得寫清楚是轉給馬軍的。 </s></s> 這話我沒說,電話上也說不清楚。她賣廠也沒有那麼快,這些事等咱們回去了再辦也不晚。</s>	neutral	neutral
<s> 也不知道能賣多少錢? 能賣多少就賣多少吧,一定要賣出去。 她們家裏都挺好的嗎? 都挺好。她聽說你叔叔二十年前扔了一個孩子,現在又找回來了,是個大小夥子,非常高興。她說中國的事怎麼這麼有意思?就像是神話故事。 她也想過來看看吧? 是呀,她特別想看看這個撿回來的孩子是個什麼樣子,也想看看韓東,看看你二叔和二嬸。 下次一定讓她來。 行,下次你就能帶她來了。哦,還有,我跟你姐說,她往這邊匯款的時候,地址這樣寫:中國,黑龍江,景陽鎮,高麗屯,韓長波收,這樣寫行嗎? 行,不過得寫清楚是轉給馬軍的。 這話我沒說,電話上也說不清楚。她賣廠也沒有那麼快,這些事等咱們回去了再辦也不晚。 </s></s> 也是。</s>	neutral	neutral
<s></s></s> 發得多嗎?</s>	surprise	fear
<s> 發得多嗎? </s></s> 發的倒不少,不知道效果咋樣?</s>	fear	fear
<s> 發得多嗎? 發的倒不少,不知道效果咋樣? </s></s> “咱們發傳單也得看對象。像剛纔那個夥計,他就惦着買黃煙呢,</s>	neutral	disgust
<s></s></s> “是。還有那些抱小駭的婦女,老太太,小學生,用不着給他們,</s>	sadness	disgust
<s> “是。還有那些抱小駭的婦女,老太太,小學生,用不着給他們, </s></s> 韓東!</s>	surprise	surprise
<s> “是。還有那些抱小駭的婦女,老太太,小學生,用不着給他們, 韓東! </s></s> 你們又來發廣告了?</s>	surprise	surprise
<s> “是。還有那些抱小駭的婦女,老太太,小學生,用不着給他們, 韓東! 你們又來發廣告了? </s></s> 是呀。你沒拉上客嗎?</s>	surprise	surprise
<s> “是。還有那些抱小駭的婦女,老太太,小學生,用不着給他們, 韓東! 你們又來發廣告了? 是呀。你沒拉上客嗎? </s></s> 不可能每趟車的人都有要出租的,那樣我就拉不過來了。下趟車再來我也幫你們發吧。</s>	neutral	joy
<s> “是。還有那些抱小駭的婦女,老太太,小學生,用不着給他們, 韓東! 你們又來發廣告了? 是呀。你沒拉上客嗎? 不可能每趟車的人都有要出租的,那樣我就拉不過來了。下趟車再來我也幫你們發吧。 </s></s> 那哪行!不能耽誤你作生意。今天可能就還有一趟客車了。</s>	joy	surprise
<s> “是。還有那些抱小駭的婦女,老太太,小學生,用不着給他們, 韓東! 你們又來發廣告了? 是呀。你沒拉上客嗎? 不可能每趟車的人都有要出租的,那樣我就拉不過來了。下趟車再來我也幫你們發吧。 那哪行!不能耽誤你作生意。今天可能就還有一趟客車了。 </s></s> 你們光在這發嗎?別的地方呢?</s>	surprise	surprise
<s> “是。還有那些抱小駭的婦女,老太太,小學生,用不着給他們, 韓東! 你們又來發廣告了? 是呀。你沒拉上客嗎? 不可能每趟車的人都有要出租的,那樣我就拉不過來了。下趟車再來我也幫你們發吧。 那哪行!不能耽誤你作生意。今天可能就還有一趟客車了。 你們光在這發嗎?別的地方呢? </s></s> 別的地方還有哪兒呀?</s>	joy	surprise
<s> “是。還有那些抱小駭的婦女,老太太,小學生,用不着給他們, 韓東! 你們又來發廣告了? 是呀。你沒拉上客嗎? 不可能每趟車的人都有要出租的,那樣我就拉不過來了。下趟車再來我也幫你們發吧。 那哪行!不能耽誤你作生意。今天可能就還有一趟客車了。 你們光在這發嗎?別的地方呢? 別的地方還有哪兒呀? </s></s> 商店、飯店、大市場,人多的地方都可以嘛。</s>	joy	neutral
<s> “是。還有那些抱小駭的婦女,老太太,小學生,用不着給他們, 韓東! 你們又來發廣告了? 是呀。你沒拉上客嗎? 不可能每趟車的人都有要出租的,那樣我就拉不過來了。下趟車再來我也幫你們發吧。 那哪行!不能耽誤你作生意。今天可能就還有一趟客車了。 你們光在這發嗎?別的地方呢? 別的地方還有哪兒呀? 商店、飯店、大市場,人多的地方都可以嘛。 </s></s> 景陽鎮就這麼大個地方,就這麼些個人,就算每個人都給到才能發多少?這邊的人也不可能上咱們這來買木頭。</s>	neutral	sadness
<s> “是。還有那些抱小駭的婦女,老太太,小學生,用不着給他們, 韓東! 你們又來發廣告了? 是呀。你沒拉上客嗎? 不可能每趟車的人都有要出租的,那樣我就拉不過來了。下趟車再來我也幫你們發吧。 那哪行!不能耽誤你作生意。今天可能就還有一趟客車了。 你們光在這發嗎?別的地方呢? 別的地方還有哪兒呀? 商店、飯店、大市場,人多的地方都可以嘛。 景陽鎮就這麼大個地方,就這麼些個人,就算每個人都給到才能發多少?這邊的人也不可能上咱們這來買木頭。 </s></s> 就是。</s>	neutral	neutral
<s> 韓東! 你們又來發廣告了? 是呀。你沒拉上客嗎? 不可能每趟車的人都有要出租的,那樣我就拉不過來了。下趟車再來我也幫你們發吧。 那哪行!不能耽誤你作生意。今天可能就還有一趟客車了。 你們光在這發嗎?別的地方呢? 別的地方還有哪兒呀? 商店、飯店、大市場,人多的地方都可以嘛。 景陽鎮就這麼大個地方,就這麼些個人,就算每個人都給到才能發多少?這邊的人也不可能上咱們這來買木頭。 就是。 </s></s> 上哈爾濱、牡丹江發去!</s>	joy	surprise
<s> 你們又來發廣告了? 是呀。你沒拉上客嗎? 不可能每趟車的人都有要出租的,那樣我就拉不過來了。下趟車再來我也幫你們發吧。 那哪行!不能耽誤你作生意。今天可能就還有一趟客車了。 你們光在這發嗎?別的地方呢? 別的地方還有哪兒呀? 商店、飯店、大市場,人多的地方都可以嘛。 景陽鎮就這麼大個地方,就這麼些個人,就算每個人都給到才能發多少?這邊的人也不可能上咱們這來買木頭。 就是。 上哈爾濱、牡丹江發去! </s></s> 我看那倒行!</s>	joy	joy
<s> 是呀。你沒拉上客嗎? 不可能每趟車的人都有要出租的,那樣我就拉不過來了。下趟車再來我也幫你們發吧。 那哪行!不能耽誤你作生意。今天可能就還有一趟客車了。 你們光在這發嗎?別的地方呢? 別的地方還有哪兒呀? 商店、飯店、大市場,人多的地方都可以嘛。 景陽鎮就這麼大個地方,就這麼些個人,就算每個人都給到才能發多少?這邊的人也不可能上咱們這來買木頭。 就是。 上哈爾濱、牡丹江發去! 我看那倒行! </s></s> 對!</s>	joy	joy
<s> 不可能每趟車的人都有要出租的,那樣我就拉不過來了。下趟車再來我也幫你們發吧。 那哪行!不能耽誤你作生意。今天可能就還有一趟客車了。 你們光在這發嗎?別的地方呢? 別的地方還有哪兒呀? 商店、飯店、大市場,人多的地方都可以嘛。 景陽鎮就這麼大個地方,就這麼些個人,就算每個人都給到才能發多少?這邊的人也不可能上咱們這來買木頭。 就是。 上哈爾濱、牡丹江發去! 我看那倒行! 對! </s></s> 上哈爾濱、牡丹江發傳單還不如作廣告呢!</s>	joy	joy
<s> 那哪行!不能耽誤你作生意。今天可能就還有一趟客車了。 你們光在這發嗎?別的地方呢? 別的地方還有哪兒呀? 商店、飯店、大市場,人多的地方都可以嘛。 景陽鎮就這麼大個地方,就這麼些個人,就算每個人都給到才能發多少?這邊的人也不可能上咱們這來買木頭。 就是。 上哈爾濱、牡丹江發去! 我看那倒行! 對! 上哈爾濱、牡丹江發傳單還不如作廣告呢! </s></s> 在報紙上作廣告當然好,可咱景陽鎮也沒有報紙呀,就一個林業報還停刊了。</s>	neutral	sadness
<s> 你們光在這發嗎?別的地方呢? 別的地方還有哪兒呀? 商店、飯店、大市場,人多的地方都可以嘛。 景陽鎮就這麼大個地方,就這麼些個人,就算每個人都給到才能發多少?這邊的人也不可能上咱們這來買木頭。 就是。 上哈爾濱、牡丹江發去! 我看那倒行! 對! 上哈爾濱、牡丹江發傳單還不如作廣告呢! 在報紙上作廣告當然好,可咱景陽鎮也沒有報紙呀,就一個林業報還停刊了。 </s></s> 林業報要是不停刊就好了。</s>	neutral	sadness
<s> 別的地方還有哪兒呀? 商店、飯店、大市場,人多的地方都可以嘛。 景陽鎮就這麼大個地方,就這麼些個人,就算每個人都給到才能發多少?這邊的人也不可能上咱們這來買木頭。 就是。 上哈爾濱、牡丹江發去! 我看那倒行! 對! 上哈爾濱、牡丹江發傳單還不如作廣告呢! 在報紙上作廣告當然好,可咱景陽鎮也沒有報紙呀,就一個林業報還停刊了。 林業報要是不停刊就好了。 </s></s> 林業報要是不停刊,馬軍也不停職就更好了。</s>	joy	sadness
<s> 商店、飯店、大市場,人多的地方都可以嘛。 景陽鎮就這麼大個地方,就這麼些個人,就算每個人都給到才能發多少?這邊的人也不可能上咱們這來買木頭。 就是。 上哈爾濱、牡丹江發去! 我看那倒行! 對! 上哈爾濱、牡丹江發傳單還不如作廣告呢! 在報紙上作廣告當然好,可咱景陽鎮也沒有報紙呀,就一個林業報還停刊了。 林業報要是不停刊就好了。 林業報要是不停刊,馬軍也不停職就更好了。 </s></s> “那都沒用!林業報是給林業工人看的,林業工人還有買木頭</s>	neutral	neutral
<s></s></s> 對!得上大報作廣告,上大地方大城市,哈爾濱、牡丹江!</s>	joy	joy
<s> 對!得上大報作廣告,上大地方大城市,哈爾濱、牡丹江! </s></s> 在那上邊作廣告可貴了。</s>	joy	fear
<s> 對!得上大報作廣告,上大地方大城市,哈爾濱、牡丹江! 在那上邊作廣告可貴了。 </s></s> 要想掙大錢就得把生意作大,就得多投入,怕花錢還行?</s>	surprise	disgust
<s> 對!得上大報作廣告,上大地方大城市,哈爾濱、牡丹江! 在那上邊作廣告可貴了。 要想掙大錢就得把生意作大,就得多投入,怕花錢還行? </s></s> 給馬軍賣印刷機的那個廠長,他不是有自己的報紙嗎?他不能作廣告嗎?</s>	angry	surprise
<s> 對!得上大報作廣告,上大地方大城市,哈爾濱、牡丹江! 在那上邊作廣告可貴了。 要想掙大錢就得把生意作大,就得多投入,怕花錢還行? 給馬軍賣印刷機的那個廠長,他不是有自己的報紙嗎?他不能作廣告嗎? </s></s> 他那是個小報。</s>	neutral	neutral
<s> 對!得上大報作廣告,上大地方大城市,哈爾濱、牡丹江! 在那上邊作廣告可貴了。 要想掙大錢就得把生意作大,就得多投入,怕花錢還行? 給馬軍賣印刷機的那個廠長,他不是有自己的報紙嗎?他不能作廣告嗎? 他那是個小報。 </s></s> 小報也行呀,城市裏發廣告的不都是小報嗎?</s>	surprise	surprise
<s> 對!得上大報作廣告,上大地方大城市,哈爾濱、牡丹江! 在那上邊作廣告可貴了。 要想掙大錢就得把生意作大,就得多投入,怕花錢還行? 給馬軍賣印刷機的那個廠長,他不是有自己的報紙嗎?他不能作廣告嗎? 他那是個小報。 小報也行呀,城市裏發廣告的不都是小報嗎? </s></s> 對!讓他給作一個。</s>	joy	joy
<s> 對!得上大報作廣告,上大地方大城市,哈爾濱、牡丹江! 在那上邊作廣告可貴了。 要想掙大錢就得把生意作大,就得多投入,怕花錢還行? 給馬軍賣印刷機的那個廠長,他不是有自己的報紙嗎?他不能作廣告嗎? 他那是個小報。 小報也行呀,城市裏發廣告的不都是小報嗎? 對!讓他給作一個。 </s></s> 就讓他作!這回馬軍遭殃還不就是因爲他!</s>	angry	angry
<s> 對!得上大報作廣告,上大地方大城市,哈爾濱、牡丹江! 在那上邊作廣告可貴了。 要想掙大錢就得把生意作大,就得多投入,怕花錢還行? 給馬軍賣印刷機的那個廠長,他不是有自己的報紙嗎?他不能作廣告嗎? 他那是個小報。 小報也行呀,城市裏發廣告的不都是小報嗎? 對!讓他給作一個。 就讓他作!這回馬軍遭殃還不就是因爲他! </s></s> 他還可以作彩色版的。</s>	joy	joy
<s> 對!得上大報作廣告,上大地方大城市,哈爾濱、牡丹江! 在那上邊作廣告可貴了。 要想掙大錢就得把生意作大,就得多投入,怕花錢還行? 給馬軍賣印刷機的那個廠長,他不是有自己的報紙嗎?他不能作廣告嗎? 他那是個小報。 小報也行呀,城市裏發廣告的不都是小報嗎? 對!讓他給作一個。 就讓他作!這回馬軍遭殃還不就是因爲他! 他還可以作彩色版的。 </s></s> 作一期還不行,得多作幾期!</s>	neutral	surprise
<s> 對!得上大報作廣告,上大地方大城市,哈爾濱、牡丹江! 在那上邊作廣告可貴了。 要想掙大錢就得把生意作大,就得多投入,怕花錢還行? 給馬軍賣印刷機的那個廠長,他不是有自己的報紙嗎?他不能作廣告嗎? 他那是個小報。 小報也行呀,城市裏發廣告的不都是小報嗎? 對!讓他給作一個。 就讓他作!這回馬軍遭殃還不就是因爲他! 他還可以作彩色版的。 作一期還不行,得多作幾期! </s></s> 你們回去跟馬軍商量商量,讓他上哈爾濱去一趟。</s>	neutral	neutral
<s> 在那上邊作廣告可貴了。 要想掙大錢就得把生意作大,就得多投入,怕花錢還行? 給馬軍賣印刷機的那個廠長,他不是有自己的報紙嗎?他不能作廣告嗎? 他那是個小報。 小報也行呀,城市裏發廣告的不都是小報嗎? 對!讓他給作一個。 就讓他作!這回馬軍遭殃還不就是因爲他! 他還可以作彩色版的。 作一期還不行,得多作幾期! 你們回去跟馬軍商量商量,讓他上哈爾濱去一趟。 </s></s> 行。</s>	joy	joy
<s></s></s> 你走吧,有人下車了。</s>	neutral	neutral
<s> 你走吧,有人下車了。 </s></s> 給我一點,我在那邊也發一下。</s>	neutral	joy
<s></s></s> “美玉,你看咱們是不是該回去了?</s>	neutral	surprise
<s> “美玉,你看咱們是不是該回去了? </s></s> 是該回去了,學校快開學了,我也有點想家了。</s>	joy	sadness
<s> “美玉,你看咱們是不是該回去了? 是該回去了,學校快開學了,我也有點想家了。 </s></s> 是,你姐說她也想咱們了。我們出來了十來天,和你叔叔他們也見了面,他們都挺好,咱們也放心了。</s>	joy	joy
<s> “美玉,你看咱們是不是該回去了? 是該回去了,學校快開學了,我也有點想家了。 是,你姐說她也想咱們了。我們出來了十來天,和你叔叔他們也見了面,他們都挺好,咱們也放心了。 </s></s> 咱們這次出來是太有義意了。</s>	joy	joy
<s> “美玉,你看咱們是不是該回去了? 是該回去了,學校快開學了,我也有點想家了。 是,你姐說她也想咱們了。我們出來了十來天,和你叔叔他們也見了面,他們都挺好,咱們也放心了。 咱們這次出來是太有義意了。 </s></s> 對,最重要的是我們分別了四十年,今年第一次見面,建立了聯繫,以後就可以經常來往,經常見面了。</s>	joy	joy
<s> “美玉,你看咱們是不是該回去了? 是該回去了,學校快開學了,我也有點想家了。 是,你姐說她也想咱們了。我們出來了十來天,和你叔叔他們也見了面,他們都挺好,咱們也放心了。 咱們這次出來是太有義意了。 對,最重要的是我們分別了四十年,今年第一次見面,建立了聯繫,以後就可以經常來往,經常見面了。 </s></s> 可是那錢還沒來,馬軍哥的問題還沒解決,怎麼辦?</s>	fear	fear
<s> “美玉,你看咱們是不是該回去了? 是該回去了,學校快開學了,我也有點想家了。 是,你姐說她也想咱們了。我們出來了十來天,和你叔叔他們也見了面,他們都挺好,咱們也放心了。 咱們這次出來是太有義意了。 對,最重要的是我們分別了四十年,今年第一次見面,建立了聯繫,以後就可以經常來往,經常見面了。 可是那錢還沒來,馬軍哥的問題還沒解決,怎麼辦? </s></s> 正因爲這樣,咱們才應該快點回去,把廠子賣了,把錢及早匯過來,讓馬軍早一點解脫。而不是在這裏等。</s>	neutral	neutral
<s> “美玉,你看咱們是不是該回去了? 是該回去了,學校快開學了,我也有點想家了。 是,你姐說她也想咱們了。我們出來了十來天,和你叔叔他們也見了面,他們都挺好,咱們也放心了。 咱們這次出來是太有義意了。 對,最重要的是我們分別了四十年,今年第一次見面,建立了聯繫,以後就可以經常來往,經常見面了。 可是那錢還沒來,馬軍哥的問題還沒解決,怎麼辦? 正因爲這樣,咱們才應該快點回去,把廠子賣了,把錢及早匯過來,讓馬軍早一點解脫。而不是在這裏等。 </s></s> 對,我明白,那咱們就馬上回去吧。</s>	neutral	joy
<s> “美玉,你看咱們是不是該回去了? 是該回去了,學校快開學了,我也有點想家了。 是,你姐說她也想咱們了。我們出來了十來天,和你叔叔他們也見了面,他們都挺好,咱們也放心了。 咱們這次出來是太有義意了。 對,最重要的是我們分別了四十年,今年第一次見面,建立了聯繫,以後就可以經常來往,經常見面了。 可是那錢還沒來,馬軍哥的問題還沒解決,怎麼辦? 正因爲這樣,咱們才應該快點回去,把廠子賣了,把錢及早匯過來,讓馬軍早一點解脫。而不是在這裏等。 對,我明白,那咱們就馬上回去吧。 </s></s> 行,你去和韓東說一下。咱們也不上他們家裏去了,去了又給他們添麻煩。還有,往這邊匯錢的事也跟韓東說一下,讓他們有個準備。</s>	neutral	neutral
<s> “美玉,你看咱們是不是該回去了? 是該回去了,學校快開學了,我也有點想家了。 是,你姐說她也想咱們了。我們出來了十來天,和你叔叔他們也見了面,他們都挺好,咱們也放心了。 咱們這次出來是太有義意了。 對,最重要的是我們分別了四十年,今年第一次見面,建立了聯繫,以後就可以經常來往,經常見面了。 可是那錢還沒來,馬軍哥的問題還沒解決,怎麼辦? 正因爲這樣,咱們才應該快點回去,把廠子賣了,把錢及早匯過來,讓馬軍早一點解脫。而不是在這裏等。 對,我明白,那咱們就馬上回去吧。 行,你去和韓東說一下。咱們也不上他們家裏去了,去了又給他們添麻煩。還有,往這邊匯錢的事也跟韓東說一下,讓他們有個準備。 </s></s> 好的,我這就去。</s>	neutral	joy
<s></s></s> 你那天在哈爾濱,沒跟那個苗廠長見面嗎?</s>	surprise	surprise
<s> 你那天在哈爾濱,沒跟那個苗廠長見面嗎? </s></s> 沒有,怎麼能讓我倆見面呢?</s>	surprise	disgust
<s> 你那天在哈爾濱,沒跟那個苗廠長見面嗎? 沒有,怎麼能讓我倆見面呢? </s></s> 完事了你也沒去找他?</s>	surprise	surprise
<s> 你那天在哈爾濱,沒跟那個苗廠長見面嗎? 沒有,怎麼能讓我倆見面呢? 完事了你也沒去找他? </s></s> 找他幹啥?我還着急回家呢。</s>	disgust	disgust
<s> 你那天在哈爾濱,沒跟那個苗廠長見面嗎? 沒有,怎麼能讓我倆見面呢? 完事了你也沒去找他? 找他幹啥?我還着急回家呢。 </s></s> 你也不知道他跟警察說了些啥?</s>	angry	fear
<s> 你那天在哈爾濱,沒跟那個苗廠長見面嗎? 沒有,怎麼能讓我倆見面呢? 完事了你也沒去找他? 找他幹啥?我還着急回家呢。 你也不知道他跟警察說了些啥? </s></s> 他說啥都沒關係,事實只有一個,我照實說就行了。</s>	neutral	neutral
<s> 你那天在哈爾濱,沒跟那個苗廠長見面嗎? 沒有,怎麼能讓我倆見面呢? 完事了你也沒去找他? 找他幹啥?我還着急回家呢。 你也不知道他跟警察說了些啥? 他說啥都沒關係,事實只有一個,我照實說就行了。 </s></s> 對,這樣對。他都應該給咱們賠償。</s>	joy	angry
<s> 你那天在哈爾濱,沒跟那個苗廠長見面嗎? 沒有,怎麼能讓我倆見面呢? 完事了你也沒去找他? 找他幹啥?我還着急回家呢。 你也不知道他跟警察說了些啥? 他說啥都沒關係,事實只有一個,我照實說就行了。 對,這樣對。他都應該給咱們賠償。 </s></s> 咋賠償?也沒定協議,就是那麼一句話,按說還是我託他幫忙呢。</s>	angry	disgust
<s> 你那天在哈爾濱,沒跟那個苗廠長見面嗎? 沒有,怎麼能讓我倆見面呢? 完事了你也沒去找他? 找他幹啥?我還着急回家呢。 你也不知道他跟警察說了些啥? 他說啥都沒關係,事實只有一個,我照實說就行了。 對,這樣對。他都應該給咱們賠償。 咋賠償?也沒定協議,就是那麼一句話,按說還是我託他幫忙呢。 </s></s> 都怪你!</s>	disgust	angry
<s> 你那天在哈爾濱,沒跟那個苗廠長見面嗎? 沒有,怎麼能讓我倆見面呢? 完事了你也沒去找他? 找他幹啥?我還着急回家呢。 你也不知道他跟警察說了些啥? 他說啥都沒關係,事實只有一個,我照實說就行了。 對,這樣對。他都應該給咱們賠償。 咋賠償?也沒定協議,就是那麼一句話,按說還是我託他幫忙呢。 都怪你! </s></s> 是,別說了。</s>	neutral	disgust
<s></s></s> 進來!</s>	joy	neutral
<s> 進來! </s></s> 苗廠長,你好!</s>	joy	joy
<s></s></s> 小馬!馬廠長,你來啦!</s>	joy	surprise
<s> 小馬!馬廠長,你來啦! </s></s> 這位姑娘是——弟妹?怎麼稱呼?</s>	surprise	surprise
<s> 小馬!馬廠長,你來啦! 這位姑娘是——弟妹?怎麼稱呼? </s></s> 她是我的女友,姓白,白鴿。</s>	joy	joy
<s> 小馬!馬廠長,你來啦! 這位姑娘是——弟妹?怎麼稱呼? 她是我的女友,姓白,白鴿。 </s></s> 白鴿?好名字!一起從景陽鎮來?</s>	joy	joy
<s></s></s> 是的。苗廠長,前幾天,哈爾濱公安局突然到景陽鎮把我叫過來了,問了我一些事,可能也找過你吧?</s>	neutral	surprise
<s> 是的。苗廠長,前幾天,哈爾濱公安局突然到景陽鎮把我叫過來了,問了我一些事,可能也找過你吧? </s></s> 噢,對了,那件事我也很想跟你說一說。這樣吧,這裏說話不太方便,也該吃飯了,咱們一塊出去吃個飯,邊吃邊談。</s>	joy	joy
<s></s></s> 也好。</s>	neutral	neutral
<s> 也好。 </s></s> 咱哥倆先喝一個,老哥我給兄弟道歉了!</s>	joy	joy
<s></s></s> 這件事我想想都窩火。你來了正好,讓我把心裏話說一說。</s>	neutral	angry
<s> 這件事我想想都窩火。你來了正好,讓我把心裏話說一說。 </s></s> 你是個挺精明的人,怎麼會做出這麼種事?</s>	surprise	surprise
<s> 這件事我想想都窩火。你來了正好,讓我把心裏話說一說。 你是個挺精明的人,怎麼會做出這麼種事? </s></s> 唉!禁不住誘惑,忘乎所以呀!你看——</s>	sadness	sadness
<s></s></s> 這是我們廠出的一張小報,也不知怎麼他把廣告作到我們的小報上來了。你看他這廣告作的:黑龍江投資諮詢公司,大公司吧?黑龍江的,像是省一級的。他不說是‘省’投資諮詢公司,光說黑龍江,不說省,這不是打馬虎眼嗎?黑龍江地方大了,景陽鎮是黑龍江,黑河也是黑龍江,誰說黑龍江都行,就是不能說省。你要說黑龍江省的投資諮詢公司,那就有人找你了,你是省裏的哪個部門呀?你在啥地方呀?你不麻煩嗎?</s>	surprise	disgust
<s> 這是我們廠出的一張小報,也不知怎麼他把廣告作到我們的小報上來了。你看他這廣告作的:黑龍江投資諮詢公司,大公司吧?黑龍江的,像是省一級的。他不說是‘省’投資諮詢公司,光說黑龍江,不說省,這不是打馬虎眼嗎?黑龍江地方大了,景陽鎮是黑龍江,黑河也是黑龍江,誰說黑龍江都行,就是不能說省。你要說黑龍江省的投資諮詢公司,那就有人找你了,你是省裏的哪個部門呀?你在啥地方呀?你不麻煩嗎? </s></s> 這種不倫不類的公司怎麼會給他註冊呢?</s>	angry	angry
<s> 這是我們廠出的一張小報,也不知怎麼他把廣告作到我們的小報上來了。你看他這廣告作的:黑龍江投資諮詢公司,大公司吧?黑龍江的,像是省一級的。他不說是‘省’投資諮詢公司,光說黑龍江,不說省,這不是打馬虎眼嗎?黑龍江地方大了,景陽鎮是黑龍江,黑河也是黑龍江,誰說黑龍江都行,就是不能說省。你要說黑龍江省的投資諮詢公司,那就有人找你了,你是省裏的哪個部門呀?你在啥地方呀?你不麻煩嗎? 這種不倫不類的公司怎麼會給他註冊呢? </s></s> 這是廣告。他自己究竟是個什麼公司誰知道?還有,他的利息特別高,月息就是百分之一,三個月的利息就等於銀行一年的了。而且他兌現快,不是按年付息是按月付息,還是月前兌現,不是月後兌現。你把錢一打進去,當月的利息就給你了。這誰不願意給他投呀?</s>	angry	angry
<s></s></s> 你不該給他投那麼多。</s>	neutral	disgust
<s> 你不該給他投那麼多。 </s></s> 是。我先投了十萬,嘿,利息一千塊立馬就來了,接着我就又投了二十萬,兩千塊利息也立馬打過來了。當時我還挺高興。</s>	joy	sadness
<s></s></s> 總共投了三十萬?</s>	surprise	surprise
<s> 總共投了三十萬? </s></s> 是呀,這事兒!我都後悔死了。</s>	sadness	sadness
<s></s></s> 你不是說你買股票了嗎?我給你打電話,你說套住了,取不出來,取出來就賠錢了。</s>	angry	surprise
<s> 你不是說你買股票了嗎?我給你打電話,你說套住了,取不出來,取出來就賠錢了。 </s></s> 是買了,沒買那麼多,我就怕賠,買了幾萬塊錢的,想觀察幾天看看行情。這時候那個投資公司的廣告來了。我一看這個機會好,就把股票賣了,全投給了那個公司。我要是全買股票也好了,就算賠也不會賠這麼多,以後還有翻本的機會,這可倒好。唉!</s>	sadness	sadness
<s></s></s> 苗廠長,馬軍在你這裏存的錢只有十四萬,你怎麼跟公安局說他有二十多萬呢?</s>	surprise	angry
<s> 苗廠長,馬軍在你這裏存的錢只有十四萬,你怎麼跟公安局說他有二十多萬呢? </s></s> 這事你們怎麼知道?</s>	surprise	surprise
<s></s></s> 你既然說了,別人還能不知道?</s>	angry	angry
<s> 你既然說了,別人還能不知道? </s></s> 我當時也有點懵了,心想馬廠長不在哈爾濱,事情是我做的他們也不會去找小馬。我少說一點,責任就少一點吧。沒想到他們把他也給叫來了。</s>	sadness	sadness
<s></s></s> 其實不管他有多少錢,這件事跟他是一點關係都沒有的。給他們投資是你決定的,你應該負完全的責任。</s>	neutral	angry
<s> 其實不管他有多少錢,這件事跟他是一點關係都沒有的。給他們投資是你決定的,你應該負完全的責任。 </s></s> 那是那是。所以我首先就向馬廠長道歉嘛。</s>	neutral	fear
<s></s></s> 道歉是應該的。可是光道歉就完了嗎?你說,十四萬塊錢,就這麼一折騰,全沒了,這麼大的損失,我們朝誰要去?誰給我們賠償?</s>	sadness	angry
<s> 道歉是應該的。可是光道歉就完了嗎?你說,十四萬塊錢,就這麼一折騰,全沒了,這麼大的損失,我們朝誰要去?誰給我們賠償? </s></s> 白小姐的意思,我得給你們賠償?</s>	neutral	fear
<s></s></s> 你說呢?</s>	surprise	angry
<s> 你說呢? </s></s> 我投出了三十萬,其中有小馬十四萬,還有我的十六萬呢。投資投錯了,是我的失誤,我有責任。投資有風險,可能賺錢,也可能賠錢,這大家都知道。可往往光想着賺錢,就想不到賠了怎麼辦?這次我沒想到,小馬也沒想到。如果小馬想到了,事先跟我說,你投資只能賺不能賠,賠了也別找我。那我根本就不給他管了。所以,小馬也有決策上的失誤。你說是不是這個道理?</s>	surprise	neutral
<s></s></s> 苗廠長別誤會。小白也是急不擇言,說說而已。我並沒有責怪廠長的意思。</s>	neutral	fear
<s> 苗廠長別誤會。小白也是急不擇言,說說而已。我並沒有責怪廠長的意思。 </s></s> 看來白小姐也是太年輕了,跟你們廠前邊來的那個姑娘一樣,都有點天真。</s>	joy	disgust
<s></s></s> 我們廠還有人來過?</s>	surprise	surprise
<s> 我們廠還有人來過? </s></s> 是呀,來了兩個人呢,都是年輕小姑娘,說我們的機器質量不好,價錢太高,是二手貨。</s>	neutral	disgust
<s></s></s> 來的人叫什麼名字?</s>	surprise	surprise
<s> 來的人叫什麼名字? </s></s> 我沒問叫什麼名字。</s>	neutral	neutral
<s></s></s> 長什麼樣?</s>	surprise	surprise
<s> 長什麼樣? </s></s> 年齡和白小姐差不多,比白小姐稍高稍胖一點。</s>	neutral	neutral
<s></s></s> 她們說什麼了?</s>	surprise	surprise
<s> 她們說什麼了? </s></s> 她們根本就是外行,還能說什麼?問了幾句話就走了。馬廠長不知道?</s>	surprise	disgust
<s></s></s> “不知道,也可能是別人叫她們來的。苗廠長</s>	surprise	neutral
<s> “不知道,也可能是別人叫她們來的。苗廠長 </s></s> 作廣告?行啊!這是我們的強項。廣告寫好了嗎?</s>	joy	joy
<s></s></s> 我們自個兒弄了一個,不知道行不行?</s>	angry	fear
<s> 我們自個兒弄了一個,不知道行不行? </s></s> 還行,就是力度不夠。</s>	neutral	joy
<s></s></s> 力度?</s>	surprise	surprise
<s> 力度? </s></s> 對,宣傳力度。作廣告要有煽動性,有誘惑力,你的廣告得讓人一看就會動心,就想嘗試。讓我上當的那個投資廣告就是這樣。當然咱們不是騙人,咱們是希望你來我這裏作生意,你來了準有利可圖,咱們是雙盈。</s>	joy	joy
<s></s></s> 你說的有道理,那就請你再給斟酌一下。</s>	neutral	joy
<s> 你說的有道理,那就請你再給斟酌一下。 </s></s> 沒問題。</s>	neutral	joy
<s></s></s> 擬好了你就直接上報吧,我也不再看了。</s>	neutral	joy
<s> 擬好了你就直接上報吧,我也不再看了。 </s></s> 行,你放心,保證給你作好。</s>	joy	joy
<s></s></s> 給我們多作幾期,費用我們一起付。</s>	joy	joy
<s> 給我們多作幾期,費用我們一起付。 </s></s> 免費!給小馬作廣告我們免費!連作十期,費用全免!</s>	joy	joy
<s></s></s> 那就謝謝苗廠長了!</s>	joy	joy
<s> 那就謝謝苗廠長了! </s></s> 謝謝!</s>	joy	joy
<s> 那就謝謝苗廠長了! 謝謝! </s></s> 不用謝!咱們是朋友嘛,謝什麼!</s>	joy	joy
<s></s></s> 爸,媽,我大爺今天就走了。</s>	neutral	neutral
<s> 爸,媽,我大爺今天就走了。 </s></s> 今天就走了?上哪兒去?</s>	surprise	surprise
<s> 爸,媽,我大爺今天就走了。 今天就走了?上哪兒去? </s></s> 回國。</s>	neutral	neutral
<s> 爸,媽,我大爺今天就走了。 今天就走了?上哪兒去? 回國。 </s></s> 回國?</s>	surprise	surprise
<s> 爸,媽,我大爺今天就走了。 今天就走了?上哪兒去? 回國。 回國? </s></s> 是呀,回南朝鮮。</s>	joy	neutral
<s> 爸,媽,我大爺今天就走了。 今天就走了?上哪兒去? 回國。 回國? 是呀,回南朝鮮。 </s></s> 這就回南朝鮮了?</s>	surprise	surprise
<s> 爸,媽,我大爺今天就走了。 今天就走了?上哪兒去? 回國。 回國? 是呀,回南朝鮮。 這就回南朝鮮了? </s></s> 是。</s>	neutral	neutral
<s> 爸,媽,我大爺今天就走了。 今天就走了?上哪兒去? 回國。 回國? 是呀,回南朝鮮。 這就回南朝鮮了? 是。 </s></s> 他們怎麼不到家裏來?</s>	surprise	surprise
<s> 爸,媽,我大爺今天就走了。 今天就走了?上哪兒去? 回國。 回國? 是呀,回南朝鮮。 這就回南朝鮮了? 是。 他們怎麼不到家裏來? </s></s> 他們說來了又給你們添麻煩,他們也沒有時間了。</s>	neutral	neutral
<s> 爸,媽,我大爺今天就走了。 今天就走了?上哪兒去? 回國。 回國? 是呀,回南朝鮮。 這就回南朝鮮了? 是。 他們怎麼不到家裏來? 他們說來了又給你們添麻煩,他們也沒有時間了。 </s></s> 唉!</s>	sadness	sadness
<s> 爸,媽,我大爺今天就走了。 今天就走了?上哪兒去? 回國。 回國? 是呀,回南朝鮮。 這就回南朝鮮了? 是。 他們怎麼不到家裏來? 他們說來了又給你們添麻煩,他們也沒有時間了。 唉! </s></s> 他們人在哪兒呢?</s>	surprise	surprise
<s> 今天就走了?上哪兒去? 回國。 回國? 是呀,回南朝鮮。 這就回南朝鮮了? 是。 他們怎麼不到家裏來? 他們說來了又給你們添麻煩,他們也沒有時間了。 唉! 他們人在哪兒呢? </s></s> 在賓館呢,就要上火車站了。</s>	neutral	neutral
<s> 回國。 回國? 是呀,回南朝鮮。 這就回南朝鮮了? 是。 他們怎麼不到家裏來? 他們說來了又給你們添麻煩,他們也沒有時間了。 唉! 他們人在哪兒呢? 在賓館呢,就要上火車站了。 </s></s> 這就上火車站了?</s>	surprise	surprise
<s> 回國? 是呀,回南朝鮮。 這就回南朝鮮了? 是。 他們怎麼不到家裏來? 他們說來了又給你們添麻煩,他們也沒有時間了。 唉! 他們人在哪兒呢? 在賓館呢,就要上火車站了。 這就上火車站了? </s></s> 這就要上火車了?那咱們去送他們吧。</s>	joy	joy
<s> 是呀,回南朝鮮。 這就回南朝鮮了? 是。 他們怎麼不到家裏來? 他們說來了又給你們添麻煩,他們也沒有時間了。 唉! 他們人在哪兒呢? 在賓館呢,就要上火車站了。 這就上火車站了? 這就要上火車了?那咱們去送他們吧。 </s></s> 對,我就是來接你們的。</s>	joy	joy
<s> 這就回南朝鮮了? 是。 他們怎麼不到家裏來? 他們說來了又給你們添麻煩,他們也沒有時間了。 唉! 他們人在哪兒呢? 在賓館呢,就要上火車站了。 這就上火車站了? 這就要上火車了?那咱們去送他們吧。 對,我就是來接你們的。 </s></s> 唉,快找件衣裳吧。</s>	sadness	surprise
<s></s></s> 就穿這次出門穿的那件衣服就行。</s>	joy	neutral
<s> 就穿這次出門穿的那件衣服就行。 </s></s> 是呀,也就那件衣裳了。</s>	joy	neutral
<s></s></s> 阿姨!叔叔!你們來了?</s>	surprise	joy
<s> 阿姨!叔叔!你們來了? </s></s> 嗯,孩子,你是——</s>	neutral	surprise
<s></s></s> 媽,他是馬軍!</s>	surprise	joy
<s> 媽,他是馬軍! </s></s> 馬軍!</s>	surprise	surprise
<s></s></s> 阿姨!您好嗎?</s>	neutral	joy
<s> 阿姨!您好嗎? </s></s> 好,好,這是你叔。</s>	joy	joy
<s></s></s> 叔叔!</s>	surprise	joy
<s> 叔叔! </s></s> 哎!</s>	surprise	joy
<s></s></s> 你多大了?</s>	surprise	surprise
<s> 你多大了? </s></s> 我二十二了。</s>	neutral	joy
<s></s></s> 二十二了?噢,對,是二十二了。你幹啥活呢?</s>	surprise	surprise
<s> 二十二了?噢,對,是二十二了。你幹啥活呢? </s></s> 我們在北溝青河林場辦了一個公司,小公司,作木材生意。</s>	joy	joy
<s></s></s> 你認識韓東嗎?</s>	surprise	surprise
<s> 你認識韓東嗎? </s></s> 認識,早就認識,我們還是朋友呢。</s>	joy	joy
<s></s></s> 對,我們早就是好朋友。這是白鴿,是馬軍的女朋友。</s>	joy	joy
<s> 對,我們早就是好朋友。這是白鴿,是馬軍的女朋友。 </s></s> 大娘!</s>	surprise	joy
<s></s></s> 白鴿?見過的,多好的姑娘!</s>	joy	joy
<s> 白鴿?見過的,多好的姑娘! </s></s> 媽,您先坐着,我去接我大爺。</s>	joy	joy
<s></s></s> 你去吧。</s>	neutral	neutral
<s> 你去吧。 </s></s> 大娘大爺,這裏坐吧。</s>	joy	joy
<s></s></s> 東哥,這麼早就來了?</s>	surprise	surprise
<s> 東哥,這麼早就來了? </s></s> 收拾好了嗎?</s>	neutral	neutral
<s> 東哥,這麼早就來了? 收拾好了嗎? </s></s> 好了。</s>	neutral	joy
<s> 東哥,這麼早就來了? 收拾好了嗎? 好了。 </s></s> 大爺,咱們就走吧?</s>	joy	surprise
<s> 東哥,這麼早就來了? 收拾好了嗎? 好了。 大爺,咱們就走吧? </s></s> 你爸媽他們呢?</s>	surprise	surprise
<s> 東哥,這麼早就來了? 收拾好了嗎? 好了。 大爺,咱們就走吧? 你爸媽他們呢? </s></s> “他們直接上</s>	neutral	neutral
<s></s></s> 他們已經去火車站了?那咱們快走吧!</s>	surprise	surprise
<s> 他們已經去火車站了?那咱們快走吧! </s></s> 走吧。</s>	neutral	neutral
<s></s></s> 噢,走了,謝謝你們!</s>	joy	joy
<s> 噢,走了,謝謝你們! </s></s> 好,希望再來!</s>	joy	joy
<s> 噢,走了,謝謝你們! 好,希望再來! </s></s> 謝謝,再見!</s>	joy	joy
<s></s></s> 美玉!</s>	joy	joy
<s> 美玉! </s></s> 你們先來了。叔叔、媽媽來了嗎?</s>	joy	surprise
<s> 美玉! 你們先來了。叔叔、媽媽來了嗎? </s></s> 來了,他們在這。</s>	joy	joy
<s></s></s> 媽媽!二叔!</s>	joy	joy
<s> 媽媽!二叔! </s></s> 這說走就走了?</s>	surprise	surprise
<s> 媽媽!二叔! 這說走就走了? </s></s> 是呀,時間不短了,該回去了。</s>	joy	neutral
<s> 媽媽!二叔! 這說走就走了? 是呀,時間不短了,該回去了。 </s></s> 還能再來嗎?</s>	surprise	fear
<s> 媽媽!二叔! 這說走就走了? 是呀,時間不短了,該回去了。 還能再來嗎? </s></s> 能來,肯定能來。</s>	joy	joy
<s> 媽媽!二叔! 這說走就走了? 是呀,時間不短了,該回去了。 還能再來嗎? 能來,肯定能來。 </s></s> 對,這回知道路了,以後一定再來看你們。</s>	joy	joy
<s></s></s> 順子,看見了嗎?那個孩子,不就是長波說的那個孩子嗎?</s>	surprise	surprise
<s> 順子,看見了嗎?那個孩子,不就是長波說的那個孩子嗎? </s></s> 嗯,看見了。</s>	neutral	neutral
<s> 順子,看見了嗎?那個孩子,不就是長波說的那個孩子嗎? 嗯,看見了。 </s></s> 和東子一樣高了。</s>	joy	joy
<s> 順子,看見了嗎?那個孩子,不就是長波說的那個孩子嗎? 嗯,看見了。 和東子一樣高了。 </s></s> 長得也一模一樣。</s>	joy	joy
<s> 順子,看見了嗎?那個孩子,不就是長波說的那個孩子嗎? 嗯,看見了。 和東子一樣高了。 長得也一模一樣。 </s></s> 親弟弟嘛。</s>	joy	joy
<s> 順子,看見了嗎?那個孩子,不就是長波說的那個孩子嗎? 嗯,看見了。 和東子一樣高了。 長得也一模一樣。 親弟弟嘛。 </s></s> 他到家裏來看過你們嗎?</s>	neutral	surprise
<s> 順子,看見了嗎?那個孩子,不就是長波說的那個孩子嗎? 嗯,看見了。 和東子一樣高了。 長得也一模一樣。 親弟弟嘛。 他到家裏來看過你們嗎? </s></s> 沒有。</s>	neutral	sadness
<s> 順子,看見了嗎?那個孩子,不就是長波說的那個孩子嗎? 嗯,看見了。 和東子一樣高了。 長得也一模一樣。 親弟弟嘛。 他到家裏來看過你們嗎? 沒有。 </s></s> 長波說的情況他知道了嗎?</s>	surprise	surprise
<s> 順子,看見了嗎?那個孩子,不就是長波說的那個孩子嗎? 嗯,看見了。 和東子一樣高了。 長得也一模一樣。 親弟弟嘛。 他到家裏來看過你們嗎? 沒有。 長波說的情況他知道了嗎? </s></s> 可能還不知道吧?誰告訴他了?</s>	surprise	fear
<s> 順子,看見了嗎?那個孩子,不就是長波說的那個孩子嗎? 嗯,看見了。 和東子一樣高了。 長得也一模一樣。 親弟弟嘛。 他到家裏來看過你們嗎? 沒有。 長波說的情況他知道了嗎? 可能還不知道吧?誰告訴他了? </s></s> 美玉說他們都已經知道了。</s>	neutral	neutral
<s> 順子,看見了嗎?那個孩子,不就是長波說的那個孩子嗎? 嗯,看見了。 和東子一樣高了。 長得也一模一樣。 親弟弟嘛。 他到家裏來看過你們嗎? 沒有。 長波說的情況他知道了嗎? 可能還不知道吧?誰告訴他了? 美玉說他們都已經知道了。 </s></s> 知道了又能怎麼樣?一幫孩子。</s>	neutral	sadness
<s> 嗯,看見了。 和東子一樣高了。 長得也一模一樣。 親弟弟嘛。 他到家裏來看過你們嗎? 沒有。 長波說的情況他知道了嗎? 可能還不知道吧?誰告訴他了? 美玉說他們都已經知道了。 知道了又能怎麼樣?一幫孩子。 </s></s> 他願不願意認你們這親爸親媽呀?</s>	sadness	fear
<s> 和東子一樣高了。 長得也一模一樣。 親弟弟嘛。 他到家裏來看過你們嗎? 沒有。 長波說的情況他知道了嗎? 可能還不知道吧?誰告訴他了? 美玉說他們都已經知道了。 知道了又能怎麼樣?一幫孩子。 他願不願意認你們這親爸親媽呀? </s></s> 誰知道?</s>	surprise	sadness
<s> 長得也一模一樣。 親弟弟嘛。 他到家裏來看過你們嗎? 沒有。 長波說的情況他知道了嗎? 可能還不知道吧?誰告訴他了? 美玉說他們都已經知道了。 知道了又能怎麼樣?一幫孩子。 他願不願意認你們這親爸親媽呀? 誰知道? </s></s> 還有,他們家的老人,他爸媽,他爺爺,他們什麼態度?</s>	neutral	fear
<s> 親弟弟嘛。 他到家裏來看過你們嗎? 沒有。 長波說的情況他知道了嗎? 可能還不知道吧?誰告訴他了? 美玉說他們都已經知道了。 知道了又能怎麼樣?一幫孩子。 他願不願意認你們這親爸親媽呀? 誰知道? 還有,他們家的老人,他爸媽,他爺爺,他們什麼態度? </s></s> 誰知道?</s>	surprise	sadness
<s> 他到家裏來看過你們嗎? 沒有。 長波說的情況他知道了嗎? 可能還不知道吧?誰告訴他了? 美玉說他們都已經知道了。 知道了又能怎麼樣?一幫孩子。 他願不願意認你們這親爸親媽呀? 誰知道? 還有,他們家的老人,他爸媽,他爺爺,他們什麼態度? 誰知道? </s></s> 咱們是不是應該直接跟他們交涉一下呢?這事我來辦也許更合適一些,可是我實在沒有時間了。長波,你能不能去跟他們談談呢?</s>	fear	surprise
<s> 沒有。 長波說的情況他知道了嗎? 可能還不知道吧?誰告訴他了? 美玉說他們都已經知道了。 知道了又能怎麼樣?一幫孩子。 他願不願意認你們這親爸親媽呀? 誰知道? 還有,他們家的老人,他爸媽,他爺爺,他們什麼態度? 誰知道? 咱們是不是應該直接跟他們交涉一下呢?這事我來辦也許更合適一些,可是我實在沒有時間了。長波,你能不能去跟他們談談呢? </s></s> 跟他們?有什麼好談的!</s>	surprise	disgust
<s> 長波說的情況他知道了嗎? 可能還不知道吧?誰告訴他了? 美玉說他們都已經知道了。 知道了又能怎麼樣?一幫孩子。 他願不願意認你們這親爸親媽呀? 誰知道? 還有,他們家的老人,他爸媽,他爺爺,他們什麼態度? 誰知道? 咱們是不是應該直接跟他們交涉一下呢?這事我來辦也許更合適一些,可是我實在沒有時間了。長波,你能不能去跟他們談談呢? 跟他們?有什麼好談的! </s></s> 唉,算了吧,知道他活着就行了,誰叫我當初把他扔了?</s>	sadness	sadness
<s></s></s> 美玉小姐回去了,什麼時候還能再來呀?</s>	surprise	fear
<s> 美玉小姐回去了,什麼時候還能再來呀? </s></s> 恐怕只能等到下次放假了。</s>	neutral	neutral
<s> 美玉小姐回去了,什麼時候還能再來呀? 恐怕只能等到下次放假了。 </s></s> 這次到家鄉來玩得痛快嗎?</s>	surprise	joy
<s> 美玉小姐回去了,什麼時候還能再來呀? 恐怕只能等到下次放假了。 這次到家鄉來玩得痛快嗎? </s></s> 很痛快,很高興。</s>	joy	joy
<s> 美玉小姐回去了,什麼時候還能再來呀? 恐怕只能等到下次放假了。 這次到家鄉來玩得痛快嗎? 很痛快,很高興。 </s></s> 你對家鄉的印象怎麼樣?</s>	joy	joy
<s> 美玉小姐回去了,什麼時候還能再來呀? 恐怕只能等到下次放假了。 這次到家鄉來玩得痛快嗎? 很痛快,很高興。 你對家鄉的印象怎麼樣? </s></s> 好極了!特別是家鄉的人好。媽媽、二叔、東哥、你、曉華姐、白鴿姐姐,都好,特別好。</s>	joy	joy
<s> 美玉小姐回去了,什麼時候還能再來呀? 恐怕只能等到下次放假了。 這次到家鄉來玩得痛快嗎? 很痛快,很高興。 你對家鄉的印象怎麼樣? 好極了!特別是家鄉的人好。媽媽、二叔、東哥、你、曉華姐、白鴿姐姐,都好,特別好。 </s></s> 一見如故,是吧?</s>	joy	joy
<s> 美玉小姐回去了,什麼時候還能再來呀? 恐怕只能等到下次放假了。 這次到家鄉來玩得痛快嗎? 很痛快,很高興。 你對家鄉的印象怎麼樣? 好極了!特別是家鄉的人好。媽媽、二叔、東哥、你、曉華姐、白鴿姐姐,都好,特別好。 一見如故,是吧? </s></s> 對。</s>	joy	joy
<s> 美玉小姐回去了,什麼時候還能再來呀? 恐怕只能等到下次放假了。 這次到家鄉來玩得痛快嗎? 很痛快,很高興。 你對家鄉的印象怎麼樣? 好極了!特別是家鄉的人好。媽媽、二叔、東哥、你、曉華姐、白鴿姐姐,都好,特別好。 一見如故,是吧? 對。 </s></s> 美不美,家鄉水,親不親,故鄉人嘛。</s>	joy	joy
<s> 美玉小姐回去了,什麼時候還能再來呀? 恐怕只能等到下次放假了。 這次到家鄉來玩得痛快嗎? 很痛快,很高興。 你對家鄉的印象怎麼樣? 好極了!特別是家鄉的人好。媽媽、二叔、東哥、你、曉華姐、白鴿姐姐,都好,特別好。 一見如故,是吧? 對。 美不美,家鄉水,親不親,故鄉人嘛。 </s></s> 對,曉華姐說得太對了。我就是這種感覺。</s>	joy	joy
<s> 美玉小姐回去了,什麼時候還能再來呀? 恐怕只能等到下次放假了。 這次到家鄉來玩得痛快嗎? 很痛快,很高興。 你對家鄉的印象怎麼樣? 好極了!特別是家鄉的人好。媽媽、二叔、東哥、你、曉華姐、白鴿姐姐,都好,特別好。 一見如故,是吧? 對。 美不美,家鄉水,親不親,故鄉人嘛。 對,曉華姐說得太對了。我就是這種感覺。 </s></s> 如果將來我們有機會到你們那裏去了,希望也有這種感覺。</s>	joy	joy
<s> 恐怕只能等到下次放假了。 這次到家鄉來玩得痛快嗎? 很痛快,很高興。 你對家鄉的印象怎麼樣? 好極了!特別是家鄉的人好。媽媽、二叔、東哥、你、曉華姐、白鴿姐姐,都好,特別好。 一見如故,是吧? 對。 美不美,家鄉水,親不親,故鄉人嘛。 對,曉華姐說得太對了。我就是這種感覺。 如果將來我們有機會到你們那裏去了,希望也有這種感覺。 </s></s> 一定有,一定的,希望你一定能來。</s>	joy	joy
<s> 這次到家鄉來玩得痛快嗎? 很痛快,很高興。 你對家鄉的印象怎麼樣? 好極了!特別是家鄉的人好。媽媽、二叔、東哥、你、曉華姐、白鴿姐姐,都好,特別好。 一見如故,是吧? 對。 美不美,家鄉水,親不親,故鄉人嘛。 對,曉華姐說得太對了。我就是這種感覺。 如果將來我們有機會到你們那裏去了,希望也有這種感覺。 一定有,一定的,希望你一定能來。 </s></s> 他巴不得去呢。</s>	joy	joy
<s> 很痛快,很高興。 你對家鄉的印象怎麼樣? 好極了!特別是家鄉的人好。媽媽、二叔、東哥、你、曉華姐、白鴿姐姐,都好,特別好。 一見如故,是吧? 對。 美不美,家鄉水,親不親,故鄉人嘛。 對,曉華姐說得太對了。我就是這種感覺。 如果將來我們有機會到你們那裏去了,希望也有這種感覺。 一定有,一定的,希望你一定能來。 他巴不得去呢。 </s></s> 爭取吧。</s>	joy	joy
<s></s></s> 時間快到了,我把車票給你們吧。</s>	neutral	surprise
<s> 時間快到了,我把車票給你們吧。 </s></s> 曉華姐把車票都買好了?</s>	surprise	surprise
<s> 時間快到了,我把車票給你們吧。 曉華姐把車票都買好了? </s></s> 是呀,不對號,你們上車以後自己找座位。</s>	joy	neutral
<s> 時間快到了,我把車票給你們吧。 曉華姐把車票都買好了? 是呀,不對號,你們上車以後自己找座位。 </s></s> 沒關係,哈爾濱不遠,幾點的?</s>	joy	joy
<s> 時間快到了,我把車票給你們吧。 曉華姐把車票都買好了? 是呀,不對號,你們上車以後自己找座位。 沒關係,哈爾濱不遠,幾點的? </s></s> 十點多,馬上就到了。</s>	joy	joy
<s> 時間快到了,我把車票給你們吧。 曉華姐把車票都買好了? 是呀,不對號,你們上車以後自己找座位。 沒關係,哈爾濱不遠,幾點的? 十點多,馬上就到了。 </s></s> 爸媽他們的呢?</s>	surprise	surprise
<s> 時間快到了,我把車票給你們吧。 曉華姐把車票都買好了? 是呀,不對號,你們上車以後自己找座位。 沒關係,哈爾濱不遠,幾點的? 十點多,馬上就到了。 爸媽他們的呢? </s></s> 在這兒。</s>	neutral	joy
<s></s></s> 我們也能進去嗎?</s>	surprise	surprise
<s> 我們也能進去嗎? </s></s> 能進,這是站臺票,不能上車。</s>	neutral	joy
<s> 我們也能進去嗎? 能進,這是站臺票,不能上車。 </s></s> 好。噢,還有一件事,你們兩個,能讓我喝上喜酒嗎?</s>	joy	joy
<s> 我們也能進去嗎? 能進,這是站臺票,不能上車。 好。噢,還有一件事,你們兩個,能讓我喝上喜酒嗎? </s></s> 能!</s>	joy	joy
<s> 我們也能進去嗎? 能進,這是站臺票,不能上車。 好。噢,還有一件事,你們兩個,能讓我喝上喜酒嗎? 能! </s></s> 這事恐怕你說了還不能算吧?</s>	fear	joy
<s> 我們也能進去嗎? 能進,這是站臺票,不能上車。 好。噢,還有一件事,你們兩個,能讓我喝上喜酒嗎? 能! 這事恐怕你說了還不能算吧? </s></s> 也算,不過這次肯定是不行了,您要喝喜酒就得再來一次。</s>	joy	joy
<s> 我們也能進去嗎? 能進,這是站臺票,不能上車。 好。噢,還有一件事,你們兩個,能讓我喝上喜酒嗎? 能! 這事恐怕你說了還不能算吧? 也算,不過這次肯定是不行了,您要喝喜酒就得再來一次。 </s></s> 好,好啊,我一定再來一次!</s>	joy	joy
<s> 我們也能進去嗎? 能進,這是站臺票,不能上車。 好。噢,還有一件事,你們兩個,能讓我喝上喜酒嗎? 能! 這事恐怕你說了還不能算吧? 也算,不過這次肯定是不行了,您要喝喜酒就得再來一次。 好,好啊,我一定再來一次! </s></s> 我也來!</s>	joy	joy
<s> 我們也能進去嗎? 能進,這是站臺票,不能上車。 好。噢,還有一件事,你們兩個,能讓我喝上喜酒嗎? 能! 這事恐怕你說了還不能算吧? 也算,不過這次肯定是不行了,您要喝喜酒就得再來一次。 好,好啊,我一定再來一次! 我也來! </s></s> 你當然得來!</s>	joy	joy
<s> 我們也能進去嗎? 能進,這是站臺票,不能上車。 好。噢,還有一件事,你們兩個,能讓我喝上喜酒嗎? 能! 這事恐怕你說了還不能算吧? 也算,不過這次肯定是不行了,您要喝喜酒就得再來一次。 好,好啊,我一定再來一次! 我也來! 你當然得來! </s></s> 韓東啊,曉華是個好姑娘,你可要珍惜呀。</s>	joy	joy
<s> 我們也能進去嗎? 能進,這是站臺票,不能上車。 好。噢,還有一件事,你們兩個,能讓我喝上喜酒嗎? 能! 這事恐怕你說了還不能算吧? 也算,不過這次肯定是不行了,您要喝喜酒就得再來一次。 好,好啊,我一定再來一次! 我也來! 你當然得來! 韓東啊,曉華是個好姑娘,你可要珍惜呀。 </s></s> 放心吧,大爺。</s>	joy	joy
<s></s></s> 檢票了,咱們走吧!</s>	joy	joy
<s> 檢票了,咱們走吧! </s></s> “媽媽!我想你們。你和二叔能來看我們嗎?</s>	joy	joy
<s></s></s> 美玉,好妹妹,別哭!你爸會傷心的。</s>	sadness	joy
<s> 美玉,好妹妹,別哭!你爸會傷心的。 </s></s> 哥!你一定要常去看媽媽,好嗎?</s>	fear	fear
<s> 美玉,好妹妹,別哭!你爸會傷心的。 哥!你一定要常去看媽媽,好嗎? </s></s> 好的,我一定去,你放心吧。</s>	joy	joy
<s> 美玉,好妹妹,別哭!你爸會傷心的。 哥!你一定要常去看媽媽,好嗎? 好的,我一定去,你放心吧。 </s></s> 白鴿姐姐,你能和哥哥一塊去看媽媽嗎?</s>	joy	fear
<s> 美玉,好妹妹,別哭!你爸會傷心的。 哥!你一定要常去看媽媽,好嗎? 好的,我一定去,你放心吧。 白鴿姐姐,你能和哥哥一塊去看媽媽嗎? </s></s> 我能!放心吧。</s>	joy	joy
<s> 美玉,好妹妹,別哭!你爸會傷心的。 哥!你一定要常去看媽媽,好嗎? 好的,我一定去,你放心吧。 白鴿姐姐,你能和哥哥一塊去看媽媽嗎? 我能!放心吧。 </s></s> 謝謝你,白鴿姐!</s>	joy	joy
<s></s></s> 韓東,你就把你爸媽送回去吧。</s>	neutral	joy
<s> 韓東,你就把你爸媽送回去吧。 </s></s> 你們呢?</s>	surprise	surprise
<s> 韓東,你就把你爸媽送回去吧。 你們呢? </s></s> 你就別管了,我們明天上青河。</s>	joy	neutral
<s> 韓東,你就把你爸媽送回去吧。 你們呢? 你就別管了,我們明天上青河。 </s></s> 好吧,我們先走了。</s>	neutral	neutral
<s></s></s> 咱們各回各家吧,明天青河見!</s>	joy	joy
<s> 咱們各回各家吧,明天青河見! </s></s> 明天見!</s>	joy	joy
<s> 咱們各回各家吧,明天青河見! 明天見! </s></s> 明天見!</s>	joy	joy
<s></s></s> 媽,你怎麼了?不舒服嗎?</s>	fear	fear
<s> 媽,你怎麼了?不舒服嗎? </s></s> 沒怎麼,就是有點累,你走吧。</s>	neutral	sadness
<s> 媽,你怎麼了?不舒服嗎? 沒怎麼,就是有點累,你走吧。 </s></s> 那我先走了,你休息吧。</s>	neutral	fear
<s></s></s> 唉,走了,都走了,怕是再也不能回來了,就像作了一場夢。</s>	sadness	sadness
<s> 唉,走了,都走了,怕是再也不能回來了,就像作了一場夢。 </s></s> 咱們要是把他們留下就好了。</s>	sadness	sadness
<s> 唉,走了,都走了,怕是再也不能回來了,就像作了一場夢。 咱們要是把他們留下就好了。 </s></s> 咱們怎麼留下他們?就這老破房子。</s>	fear	sadness
<s> 唉,走了,都走了,怕是再也不能回來了,就像作了一場夢。 咱們要是把他們留下就好了。 咱們怎麼留下他們?就這老破房子。 </s></s> 那咱們跟他們出去?</s>	surprise	surprise
<s> 唉,走了,都走了,怕是再也不能回來了,就像作了一場夢。 咱們要是把他們留下就好了。 咱們怎麼留下他們?就這老破房子。 那咱們跟他們出去? </s></s> 出去了你能幹啥?喝西北風去?你連地都不會種,外邊也不知道有沒有地種。</s>	disgust	disgust
<s> 唉,走了,都走了,怕是再也不能回來了,就像作了一場夢。 咱們要是把他們留下就好了。 咱們怎麼留下他們?就這老破房子。 那咱們跟他們出去? 出去了你能幹啥?喝西北風去?你連地都不會種,外邊也不知道有沒有地種。 </s></s> 怎麼會沒有地種呢?他們不吃糧食?</s>	surprise	surprise
<s> 唉,走了,都走了,怕是再也不能回來了,就像作了一場夢。 咱們要是把他們留下就好了。 咱們怎麼留下他們?就這老破房子。 那咱們跟他們出去? 出去了你能幹啥?喝西北風去?你連地都不會種,外邊也不知道有沒有地種。 怎麼會沒有地種呢?他們不吃糧食? </s></s> 有地,你會種嗎?</s>	surprise	surprise
<s> 唉,走了,都走了,怕是再也不能回來了,就像作了一場夢。 咱們要是把他們留下就好了。 咱們怎麼留下他們?就這老破房子。 那咱們跟他們出去? 出去了你能幹啥?喝西北風去?你連地都不會種,外邊也不知道有沒有地種。 怎麼會沒有地種呢?他們不吃糧食? 有地,你會種嗎? </s></s> 你不是會種嗎?</s>	surprise	surprise
<s> 唉,走了,都走了,怕是再也不能回來了,就像作了一場夢。 咱們要是把他們留下就好了。 咱們怎麼留下他們?就這老破房子。 那咱們跟他們出去? 出去了你能幹啥?喝西北風去?你連地都不會種,外邊也不知道有沒有地種。 怎麼會沒有地種呢?他們不吃糧食? 有地,你會種嗎? 你不是會種嗎? </s></s> 我?我可幹不動了,我還能活幾年?</s>	surprise	sadness
<s> 唉,走了,都走了,怕是再也不能回來了,就像作了一場夢。 咱們要是把他們留下就好了。 咱們怎麼留下他們?就這老破房子。 那咱們跟他們出去? 出去了你能幹啥?喝西北風去?你連地都不會種,外邊也不知道有沒有地種。 怎麼會沒有地種呢?他們不吃糧食? 有地,你會種嗎? 你不是會種嗎? 我?我可幹不動了,我還能活幾年? </s></s> 別瞎說!過兩年咱們去看他們。</s>	joy	joy
<s> 唉,走了,都走了,怕是再也不能回來了,就像作了一場夢。 咱們要是把他們留下就好了。 咱們怎麼留下他們?就這老破房子。 那咱們跟他們出去? 出去了你能幹啥?喝西北風去?你連地都不會種,外邊也不知道有沒有地種。 怎麼會沒有地種呢?他們不吃糧食? 有地,你會種嗎? 你不是會種嗎? 我?我可幹不動了,我還能活幾年? 別瞎說!過兩年咱們去看他們。 </s></s> 去看他們?過兩年?唉!</s>	surprise	sadness
<s> 咱們要是把他們留下就好了。 咱們怎麼留下他們?就這老破房子。 那咱們跟他們出去? 出去了你能幹啥?喝西北風去?你連地都不會種,外邊也不知道有沒有地種。 怎麼會沒有地種呢?他們不吃糧食? 有地,你會種嗎? 你不是會種嗎? 我?我可幹不動了,我還能活幾年? 別瞎說!過兩年咱們去看他們。 去看他們?過兩年?唉! </s></s> 你躺着吧,我去做飯。</s>	neutral	neutral
<s></s></s> 奶奶!奶奶!</s>	surprise	surprise
<s> 奶奶!奶奶! </s></s> 嗯!怎麼了?你是誰?</s>	surprise	surprise
<s> 奶奶!奶奶! 嗯!怎麼了?你是誰? </s></s> 奶奶,爺爺在外邊摔倒了,起不來了!</s>	fear	fear
<s></s></s> 誰摔倒了?</s>	fear	surprise
<s> 誰摔倒了? </s></s> 是爺爺!爺爺摔倒了!</s>	sadness	surprise
<s></s></s> 啊!他在哪兒?</s>	surprise	surprise
<s> 啊!他在哪兒? </s></s> 就在院子裏。</s>	neutral	fear
<s></s></s> 長波!你怎麼了?起不來了?</s>	surprise	fear
<s> 長波!你怎麼了?起不來了? </s></s> 我的腰疼,疼得厲害,不能動了。</s>	sadness	sadness
<s> 長波!你怎麼了?起不來了? 我的腰疼,疼得厲害,不能動了。 </s></s> 不行,你得起來,扶着我,起來!孩子們,幫我一把!</s>	fear	fear
<s></s></s> 謝謝孩子們!你們回家吧,到家裏跟你們家大人說,高麗屯的韓長波病了,有人到鎮上去,請他給長波的孩子帶個信兒。長波的孩子叫韓東,在鎮上開出租車,一到火車站就能找到他,就說他的爸爸病倒了,讓他趕快回家來。好嗎?</s>	joy	fear
<s> 謝謝孩子們!你們回家吧,到家裏跟你們家大人說,高麗屯的韓長波病了,有人到鎮上去,請他給長波的孩子帶個信兒。長波的孩子叫韓東,在鎮上開出租車,一到火車站就能找到他,就說他的爸爸病倒了,讓他趕快回家來。好嗎? </s></s> 行,奶奶,我們一定說。</s>	joy	joy
<s></s></s> 這是出租車嗎?</s>	surprise	neutral
<s> 這是出租車嗎? </s></s> 是的,您上哪兒?</s>	neutral	joy
<s> 這是出租車嗎? 是的,您上哪兒? </s></s> 上青河,能去嗎?</s>	surprise	surprise
<s> 這是出租車嗎? 是的,您上哪兒? 上青河,能去嗎? </s></s> 能去。</s>	joy	joy
<s> 這是出租車嗎? 是的,您上哪兒? 上青河,能去嗎? 能去。 </s></s> 多少錢?</s>	surprise	surprise
<s></s></s> 你們都是高麗屯的嗎?</s>	surprise	surprise
<s> 你們都是高麗屯的嗎? </s></s> 是的。</s>	neutral	neutral
<s></s></s> 是奶奶叫你們來的嗎?</s>	surprise	surprise
<s> 是奶奶叫你們來的嗎? </s></s> 是的。</s>	neutral	neutral
<s></s></s> 到家了,謝謝小同學,你們都回家吧。</s>	joy	joy
<s> 到家了,謝謝小同學,你們都回家吧。 </s></s> 東哥再見!</s>	joy	joy
<s></s></s> 媽,爸怎麼了?</s>	surprise	fear
<s> 媽,爸怎麼了? </s></s> 他去抱柴禾,把腰給閃了。</s>	neutral	fear
<s> 媽,爸怎麼了? 他去抱柴禾,把腰給閃了。 </s></s> 抱柴禾把腰閃了?抱柴禾還能把腰閃了?</s>	surprise	surprise
<s> 媽,爸怎麼了? 他去抱柴禾,把腰給閃了。 抱柴禾把腰閃了?抱柴禾還能把腰閃了? </s></s> 他的腰不是一直都不好嗎?</s>	surprise	fear
<s> 媽,爸怎麼了? 他去抱柴禾,把腰給閃了。 抱柴禾把腰閃了?抱柴禾還能把腰閃了? 他的腰不是一直都不好嗎? </s></s> 疼得厲害嗎?</s>	fear	fear
<s> 媽,爸怎麼了? 他去抱柴禾,把腰給閃了。 抱柴禾把腰閃了?抱柴禾還能把腰閃了? 他的腰不是一直都不好嗎? 疼得厲害嗎? </s></s> 你看他那樣兒,還能不厲害?</s>	sadness	fear
<s> 媽,爸怎麼了? 他去抱柴禾,把腰給閃了。 抱柴禾把腰閃了?抱柴禾還能把腰閃了? 他的腰不是一直都不好嗎? 疼得厲害嗎? 你看他那樣兒,還能不厲害? </s></s> 那咱們上醫院吧?</s>	fear	fear
<s> 媽,爸怎麼了? 他去抱柴禾,把腰給閃了。 抱柴禾把腰閃了?抱柴禾還能把腰閃了? 他的腰不是一直都不好嗎? 疼得厲害嗎? 你看他那樣兒,還能不厲害? 那咱們上醫院吧? </s></s> 上醫院?長這麼大也沒上過醫院。</s>	surprise	surprise
<s> 媽,爸怎麼了? 他去抱柴禾,把腰給閃了。 抱柴禾把腰閃了?抱柴禾還能把腰閃了? 他的腰不是一直都不好嗎? 疼得厲害嗎? 你看他那樣兒,還能不厲害? 那咱們上醫院吧? 上醫院?長這麼大也沒上過醫院。 </s></s> 現在情況不一樣了,你們年紀也大了,該去就得去,光在家這麼挺着還行嗎?</s>	sadness	fear
<s> 媽,爸怎麼了? 他去抱柴禾,把腰給閃了。 抱柴禾把腰閃了?抱柴禾還能把腰閃了? 他的腰不是一直都不好嗎? 疼得厲害嗎? 你看他那樣兒,還能不厲害? 那咱們上醫院吧? 上醫院?長這麼大也沒上過醫院。 現在情況不一樣了,你們年紀也大了,該去就得去,光在家這麼挺着還行嗎? </s></s> 我不上醫院。</s>	neutral	angry
<s> 媽,爸怎麼了? 他去抱柴禾,把腰給閃了。 抱柴禾把腰閃了?抱柴禾還能把腰閃了? 他的腰不是一直都不好嗎? 疼得厲害嗎? 你看他那樣兒,還能不厲害? 那咱們上醫院吧? 上醫院?長這麼大也沒上過醫院。 現在情況不一樣了,你們年紀也大了,該去就得去,光在家這麼挺着還行嗎? 我不上醫院。 </s></s> 那時候把他打成那樣,比這厲害多了也沒上醫院,不是也挺過來了?</s>	sadness	surprise
<s> 他去抱柴禾,把腰給閃了。 抱柴禾把腰閃了?抱柴禾還能把腰閃了? 他的腰不是一直都不好嗎? 疼得厲害嗎? 你看他那樣兒,還能不厲害? 那咱們上醫院吧? 上醫院?長這麼大也沒上過醫院。 現在情況不一樣了,你們年紀也大了,該去就得去,光在家這麼挺着還行嗎? 我不上醫院。 那時候把他打成那樣,比這厲害多了也沒上醫院,不是也挺過來了? </s></s> 那時候你們年輕,受了多少罪?雖然挺過來了,不是也留下後遺症了嗎?</s>	sadness	fear
<s> 抱柴禾把腰閃了?抱柴禾還能把腰閃了? 他的腰不是一直都不好嗎? 疼得厲害嗎? 你看他那樣兒,還能不厲害? 那咱們上醫院吧? 上醫院?長這麼大也沒上過醫院。 現在情況不一樣了,你們年紀也大了,該去就得去,光在家這麼挺着還行嗎? 我不上醫院。 那時候把他打成那樣,比這厲害多了也沒上醫院,不是也挺過來了? 那時候你們年輕,受了多少罪?雖然挺過來了,不是也留下後遺症了嗎? </s></s> 現在都老了,還怕後遺症嗎?</s>	angry	sadness
<s> 他的腰不是一直都不好嗎? 疼得厲害嗎? 你看他那樣兒,還能不厲害? 那咱們上醫院吧? 上醫院?長這麼大也沒上過醫院。 現在情況不一樣了,你們年紀也大了,該去就得去,光在家這麼挺着還行嗎? 我不上醫院。 那時候把他打成那樣,比這厲害多了也沒上醫院,不是也挺過來了? 那時候你們年輕,受了多少罪?雖然挺過來了,不是也留下後遺症了嗎? 現在都老了,還怕後遺症嗎? </s></s> 現在不是後遺症的問題,就怕挺不過去了!</s>	angry	fear
<s> 疼得厲害嗎? 你看他那樣兒,還能不厲害? 那咱們上醫院吧? 上醫院?長這麼大也沒上過醫院。 現在情況不一樣了,你們年紀也大了,該去就得去,光在家這麼挺着還行嗎? 我不上醫院。 那時候把他打成那樣,比這厲害多了也沒上醫院,不是也挺過來了? 那時候你們年輕,受了多少罪?雖然挺過來了,不是也留下後遺症了嗎? 現在都老了,還怕後遺症嗎? 現在不是後遺症的問題,就怕挺不過去了! </s></s> 唉!</s>	sadness	sadness
<s> 你看他那樣兒,還能不厲害? 那咱們上醫院吧? 上醫院?長這麼大也沒上過醫院。 現在情況不一樣了,你們年紀也大了,該去就得去,光在家這麼挺着還行嗎? 我不上醫院。 那時候把他打成那樣,比這厲害多了也沒上醫院,不是也挺過來了? 那時候你們年輕,受了多少罪?雖然挺過來了,不是也留下後遺症了嗎? 現在都老了,還怕後遺症嗎? 現在不是後遺症的問題,就怕挺不過去了! 唉! </s></s> 走,快點,上醫院!</s>	fear	surprise
<s> 那咱們上醫院吧? 上醫院?長這麼大也沒上過醫院。 現在情況不一樣了,你們年紀也大了,該去就得去,光在家這麼挺着還行嗎? 我不上醫院。 那時候把他打成那樣,比這厲害多了也沒上醫院,不是也挺過來了? 那時候你們年輕,受了多少罪?雖然挺過來了,不是也留下後遺症了嗎? 現在都老了,還怕後遺症嗎? 現在不是後遺症的問題,就怕挺不過去了! 唉! 走,快點,上醫院! </s></s> 我不上醫院!</s>	angry	angry
<s> 上醫院?長這麼大也沒上過醫院。 現在情況不一樣了,你們年紀也大了,該去就得去,光在家這麼挺着還行嗎? 我不上醫院。 那時候把他打成那樣,比這厲害多了也沒上醫院,不是也挺過來了? 那時候你們年輕,受了多少罪?雖然挺過來了,不是也留下後遺症了嗎? 現在都老了,還怕後遺症嗎? 現在不是後遺症的問題,就怕挺不過去了! 唉! 走,快點,上醫院! 我不上醫院! </s></s> 不行!馬上上醫院!咱們有車,很方便。媽,你給拿上住院的東西,咱們走!</s>	surprise	surprise
<s></s></s> 韓先生走了嗎?</s>	surprise	surprise
<s> 韓先生走了嗎? </s></s> 走了。</s>	neutral	neutral
<s> 韓先生走了嗎? 走了。 </s></s> 你們到車站去送了嗎?</s>	surprise	surprise
<s></s></s> 送了。</s>	neutral	neutral
<s> 送了。 </s></s> 都有誰去送了?</s>	surprise	surprise
<s></s></s> 韓東他們一家,還有曉華姐和白鴿。</s>	joy	neutral
<s> 韓東他們一家,還有曉華姐和白鴿。 </s></s> 四十年沒見面了,回來一趟可真不容易。</s>	neutral	joy
<s> 韓東他們一家,還有曉華姐和白鴿。 四十年沒見面了,回來一趟可真不容易。 </s></s> 以後就好了,隨時都可以回來,他們這邊的還可以過去。</s>	joy	neutral
<s> 韓東他們一家,還有曉華姐和白鴿。 四十年沒見面了,回來一趟可真不容易。 以後就好了,隨時都可以回來,他們這邊的還可以過去。 </s></s> 外國親戚來了,也沒給她們帶點啥東西?</s>	surprise	neutral
<s></s></s> 韓東說,他大爺給他們留下了兩萬塊錢。韓東想給爸媽把房子修一下,讓他媽開個幼兒園。他媽喜歡孩子,正好開個幼兒園看孩子。</s>	neutral	joy
<s> 韓東說,他大爺給他們留下了兩萬塊錢。韓東想給爸媽把房子修一下,讓他媽開個幼兒園。他媽喜歡孩子,正好開個幼兒園看孩子。 </s></s> 這好,辦個幼兒園,老兩口有事情幹了,也能貼補一點生活費。</s>	joy	joy
<s></s></s> 開幼兒園有啥意思?還不如辦個學校呢!希望小學。</s>	neutral	disgust
<s> 開幼兒園有啥意思?還不如辦個學校呢!希望小學。 </s></s> 辦學校兩萬塊錢可不夠。</s>	fear	disgust
<s></s></s> 可以向銀行貸款嘛。</s>	joy	neutral
<s> 可以向銀行貸款嘛。 </s></s> 還能貸款?</s>	surprise	surprise
<s></s></s> 那咋不能?作買賣的能貸,辦學校的爲啥不能貸?再說,人家辦的是民族小學。</s>	surprise	surprise
<s> 那咋不能?作買賣的能貸,辦學校的爲啥不能貸?再說,人家辦的是民族小學。 </s></s> “這倒是個路子,寶林你看呢?</s>	joy	joy
<s> 那咋不能?作買賣的能貸,辦學校的爲啥不能貸?再說,人家辦的是民族小學。 “這倒是個路子,寶林你看呢? </s></s> 我看行,就不知道他們老兩口願不願意辦?</s>	disgust	neutral
<s> 那咋不能?作買賣的能貸,辦學校的爲啥不能貸?再說,人家辦的是民族小學。 “這倒是個路子,寶林你看呢? 我看行,就不知道他們老兩口願不願意辦? </s></s> 小軍去問問他們願不願意辦。</s>	neutral	neutral
<s></s></s> 這事兒還用我問?人家自個兒還不會商量?</s>	angry	disgust
<s> 這事兒還用我問?人家自個兒還不會商量? </s></s> 他們要是願意辦,寶林小軍你們都幫個忙,讓他們辦起來,這是個好事兒。</s>	joy	joy
<s> 這事兒還用我問?人家自個兒還不會商量? 他們要是願意辦,寶林小軍你們都幫個忙,讓他們辦起來,這是個好事兒。 </s></s> 幫忙是沒問題的。要辦學校光自己願意還不行,得有那個能力,得把學校管起來,管好。</s>	joy	neutral
<s> 這事兒還用我問?人家自個兒還不會商量? 他們要是願意辦,寶林小軍你們都幫個忙,讓他們辦起來,這是個好事兒。 幫忙是沒問題的。要辦學校光自己願意還不行,得有那個能力,得把學校管起來,管好。 </s></s> 那是,這方面的事政府也不會不管。</s>	joy	fear
<s></s></s> 韓東還說,先把那兩萬塊錢拿來給我還債。</s>	neutral	neutral
<s> 韓東還說,先把那兩萬塊錢拿來給我還債。 </s></s> 這可不合適吧?咱怎麼能要人家的錢呢?</s>	angry	fear
<s></s></s> 所以我沒答應他。</s>	sadness	neutral
<s> 所以我沒答應他。 </s></s> 這有啥不合適的?他們不是說小軍是他們家的人嗎?</s>	angry	disgust
<s></s></s> 咱們到現在不是也沒承認我是他們家的人嗎?</s>	angry	disgust
<s> 咱們到現在不是也沒承認我是他們家的人嗎? </s></s> 小軍不是一直也沒過去嗎?</s>	surprise	surprise
<s> 咱們到現在不是也沒承認我是他們家的人嗎? 小軍不是一直也沒過去嗎? </s></s> 不要是對的。用兩萬塊錢還債那是杯水車薪,可是對他們來說,能解決大問題。</s>	neutral	neutral
<s> 咱們到現在不是也沒承認我是他們家的人嗎? 小軍不是一直也沒過去嗎? 不要是對的。用兩萬塊錢還債那是杯水車薪,可是對他們來說,能解決大問題。 </s></s> 小軍那事怎麼辦呀?你到底是認不認你那個親爸親媽呀?</s>	angry	fear
<s></s></s> 不是說要作個親子鑑定嗎?</s>	surprise	surprise
<s> 不是說要作個親子鑑定嗎? </s></s> 親子鑑定不是兩邊都得作嗎?</s>	surprise	surprise
<s></s></s> 做吧,我這邊沒問題。</s>	joy	neutral
<s> 做吧,我這邊沒問題。 </s></s> 他們那邊誰作呀?</s>	surprise	fear
<s></s></s> 韓東他爸唄。</s>	joy	neutral
<s> 韓東他爸唄。 </s></s> 跟他們說了嗎?</s>	surprise	surprise
<s></s></s> 我跟韓東說了,誰知道他跟沒跟他爸說?</s>	angry	surprise
<s> 我跟韓東說了,誰知道他跟沒跟他爸說? </s></s> 這事應該他們着急呀,他怎麼不快說呢?噢,我上午上街在醫院門口看見韓長脖住院了。</s>	surprise	surprise
<s></s></s> 韓東他爸住院了?</s>	surprise	surprise
<s> 韓東他爸住院了? </s></s> 住沒住院我不知道。我看見韓東抱着他爸進了醫院的大門。他媽在後邊跟着。看樣子病得挺重,那還不得住院?</s>	surprise	fear
<s></s></s> 我們送站的時候還好好的嘛!怎麼一下就病了呢?</s>	fear	surprise
<s> 我們送站的時候還好好的嘛!怎麼一下就病了呢? </s></s> 可能得的是啥急病吧?</s>	fear	neutral
<s></s></s> 能得啥急病呀?</s>	fear	fear
<s> 能得啥急病呀? </s></s> 小軍你今天不去青河了吧?</s>	neutral	surprise
<s></s></s> 不去了,明天去。</s>	neutral	neutral
<s> 不去了,明天去。 </s></s> 下午你跟我上趟醫院。</s>	neutral	neutral
<s> 不去了,明天去。 下午你跟我上趟醫院。 </s></s> 你上醫院幹啥?</s>	surprise	surprise
<s> 不去了,明天去。 下午你跟我上趟醫院。 你上醫院幹啥? </s></s> 看看韓長脖。</s>	neutral	neutral
<s> 不去了,明天去。 下午你跟我上趟醫院。 你上醫院幹啥? 看看韓長脖。 </s></s> 你看他幹啥?</s>	surprise	disgust
<s> 不去了,明天去。 下午你跟我上趟醫院。 你上醫院幹啥? 看看韓長脖。 你看他幹啥? </s></s> 要是真病了,應該去看看。</s>	neutral	fear
<s></s></s> 我說您還是別去了,就像那次會餐那樣,他們看見您又該緊張了。</s>	neutral	fear
<s> 我說您還是別去了,就像那次會餐那樣,他們看見您又該緊張了。 </s></s> 那次是太突然了,多少年不見,冷不丁見了還不緊張?這次不同了,有了上次的經歷,這回就不會再突然了。再說,有了小軍這層關係,也應該去看看,不管以前咋樣,也不管小軍的事是真是假,以後都應該把關係搞好。</s>	joy	neutral
<s></s></s> 爺爺說得對。</s>	neutral	neutral
<s> 爺爺說得對。 </s></s> 這次可以不跟他們見面,我先瞭解瞭解情況。</s>	neutral	neutral
<s></s></s> 這還行。</s>	neutral	neutral
<s> 這還行。 </s></s> 馬軍!你怎麼來了?</s>	surprise	surprise
<s> 這還行。 馬軍!你怎麼來了? </s></s> 阿姨!</s>	joy	joy
<s> 這還行。 馬軍!你怎麼來了? 阿姨! </s></s> 小軍來了。</s>	neutral	joy
<s> 這還行。 馬軍!你怎麼來了? 阿姨! 小軍來了。 </s></s> 阿姨!叔叔怎麼了?</s>	surprise	fear
<s> 這還行。 馬軍!你怎麼來了? 阿姨! 小軍來了。 阿姨!叔叔怎麼了? </s></s> 他不自在。</s>	sadness	sadness
<s> 這還行。 馬軍!你怎麼來了? 阿姨! 小軍來了。 阿姨!叔叔怎麼了? 他不自在。 </s></s> 從車站回到家,他去抱柴禾,可能是閃着腰了。</s>	neutral	fear
<s> 這還行。 馬軍!你怎麼來了? 阿姨! 小軍來了。 阿姨!叔叔怎麼了? 他不自在。 從車站回到家,他去抱柴禾,可能是閃着腰了。 </s></s> 閃了腰還這麼厲害?</s>	surprise	surprise
<s> 這還行。 馬軍!你怎麼來了? 阿姨! 小軍來了。 阿姨!叔叔怎麼了? 他不自在。 從車站回到家,他去抱柴禾,可能是閃着腰了。 閃了腰還這麼厲害? </s></s> 可能因爲年紀大了吧?</s>	neutral	neutral
<s> 這還行。 馬軍!你怎麼來了? 阿姨! 小軍來了。 阿姨!叔叔怎麼了? 他不自在。 從車站回到家,他去抱柴禾,可能是閃着腰了。 閃了腰還這麼厲害? 可能因爲年紀大了吧? </s></s> 醫生怎麼說?要住院吧?</s>	fear	fear
<s> 這還行。 馬軍!你怎麼來了? 阿姨! 小軍來了。 阿姨!叔叔怎麼了? 他不自在。 從車站回到家,他去抱柴禾,可能是閃着腰了。 閃了腰還這麼厲害? 可能因爲年紀大了吧? 醫生怎麼說?要住院吧? </s></s> 醫生說還得動手術呢。</s>	neutral	fear
<s> 馬軍!你怎麼來了? 阿姨! 小軍來了。 阿姨!叔叔怎麼了? 他不自在。 從車站回到家,他去抱柴禾,可能是閃着腰了。 閃了腰還這麼厲害? 可能因爲年紀大了吧? 醫生怎麼說?要住院吧? 醫生說還得動手術呢。 </s></s> 動手術?在腰上動手術?</s>	surprise	surprise
<s> 阿姨! 小軍來了。 阿姨!叔叔怎麼了? 他不自在。 從車站回到家,他去抱柴禾,可能是閃着腰了。 閃了腰還這麼厲害? 可能因爲年紀大了吧? 醫生怎麼說?要住院吧? 醫生說還得動手術呢。 動手術?在腰上動手術? </s></s> 是吧。</s>	neutral	sadness
<s> 小軍來了。 阿姨!叔叔怎麼了? 他不自在。 從車站回到家,他去抱柴禾,可能是閃着腰了。 閃了腰還這麼厲害? 可能因爲年紀大了吧? 醫生怎麼說?要住院吧? 醫生說還得動手術呢。 動手術?在腰上動手術? 是吧。 </s></s> 在咱們這不能動吧?</s>	fear	fear
<s> 阿姨!叔叔怎麼了? 他不自在。 從車站回到家,他去抱柴禾,可能是閃着腰了。 閃了腰還這麼厲害? 可能因爲年紀大了吧? 醫生怎麼說?要住院吧? 醫生說還得動手術呢。 動手術?在腰上動手術? 是吧。 在咱們這不能動吧? </s></s> 可能得上牡丹江。我爸說他不動手術。</s>	neutral	sadness
<s> 他不自在。 從車站回到家,他去抱柴禾,可能是閃着腰了。 閃了腰還這麼厲害? 可能因爲年紀大了吧? 醫生怎麼說?要住院吧? 醫生說還得動手術呢。 動手術?在腰上動手術? 是吧。 在咱們這不能動吧? 可能得上牡丹江。我爸說他不動手術。 </s></s> 有病了該動就得動,咱們勸勸他,可能得花很多錢吧?</s>	fear	fear
<s> 從車站回到家,他去抱柴禾,可能是閃着腰了。 閃了腰還這麼厲害? 可能因爲年紀大了吧? 醫生怎麼說?要住院吧? 醫生說還得動手術呢。 動手術?在腰上動手術? 是吧。 在咱們這不能動吧? 可能得上牡丹江。我爸說他不動手術。 有病了該動就得動,咱們勸勸他,可能得花很多錢吧? </s></s> 錢倒不怕,我這有兩萬塊呢,我大爺給的。</s>	fear	neutral
<s> 閃了腰還這麼厲害? 可能因爲年紀大了吧? 醫生怎麼說?要住院吧? 醫生說還得動手術呢。 動手術?在腰上動手術? 是吧。 在咱們這不能動吧? 可能得上牡丹江。我爸說他不動手術。 有病了該動就得動,咱們勸勸他,可能得花很多錢吧? 錢倒不怕,我這有兩萬塊呢,我大爺給的。 </s></s> 兩萬夠嗎?</s>	surprise	fear
<s> 可能因爲年紀大了吧? 醫生怎麼說?要住院吧? 醫生說還得動手術呢。 動手術?在腰上動手術? 是吧。 在咱們這不能動吧? 可能得上牡丹江。我爸說他不動手術。 有病了該動就得動,咱們勸勸他,可能得花很多錢吧? 錢倒不怕,我這有兩萬塊呢,我大爺給的。 兩萬夠嗎? </s></s> 兩萬還不夠?</s>	surprise	surprise
<s></s></s> 他那麼忙,他來幹啥?</s>	surprise	surprise
<s> 他那麼忙,他來幹啥? </s></s> 他在大夫那兒,說問問情況,不上這來。</s>	neutral	neutral
<s></s></s> 病人的情況怎麼樣?</s>	fear	fear
<s> 病人的情況怎麼樣? </s></s> 病得挺嚴重的,聽說還得動手術呢。</s>	fear	fear
<s> 病人的情況怎麼樣? 病得挺嚴重的,聽說還得動手術呢。 </s></s> 是挺嚴重,我問院長了,得作手術,還得轉院。他的情緒怎麼樣?</s>	fear	fear
<s></s></s> 情緒也不好,光鬧着要回家。</s>	sadness	sadness
<s> 情緒也不好,光鬧着要回家。 </s></s> 不行,一定要說服他,要作手術,否則就得癱瘓。先把你阿姨說服了,讓她跟你們一起做工作,還有韓東。首先你們得統一認識。這不是嚇唬他,這是真的,這是院長說的。他的病不是現在纔有,早就有了,現在是復發,再不根治就好不了了。費用的事他們不用發愁。我現在就回去拿錢給他把押金交上。</s>	neutral	neutral
<s></s></s> 韓東說他有錢,大爺走的時候給他留下了兩萬塊錢呢。</s>	neutral	neutral
<s> 韓東說他有錢,大爺走的時候給他留下了兩萬塊錢呢。 </s></s> 那是他的錢。這回治病的錢由我出。</s>	neutral	neutral
<s></s></s> 爸!</s>	surprise	surprise
<s> 爸! </s></s> 不要說了,趕緊去準備,馬上轉院,上哈爾濱!</s>	surprise	angry
<s></s></s> 上哈爾濱?</s>	surprise	surprise
<s> 上哈爾濱? </s></s> 對,上哈爾濱!</s>	joy	neutral
<s></s></s> 那得花多少錢呀?</s>	surprise	fear
<s> 那得花多少錢呀? </s></s> 錢的事您不用愁。我大爺走的時候就說了,叫咱們給我爸治病,給我們留了一點錢,夠用的。</s>	joy	joy
<s></s></s> 好吧。</s>	neutral	neutral
<s> 好吧。 </s></s> 那倒沒有。</s>	neutral	neutral
<s></s></s> 那她應該跟家裏說一聲呀。</s>	fear	fear
<s> 那她應該跟家裏說一聲呀。 </s></s> 徐師傅,你先把你女兒的情況跟我詳細談一談。咱們到這邊來。</s>	neutral	neutral
<s> 那她應該跟家裏說一聲呀。 徐師傅,你先把你女兒的情況跟我詳細談一談。咱們到這邊來。 </s></s> 好吧。那你們就回去吧!</s>	neutral	neutral
<s></s></s> “咋能沒關係?從近裏說跟我有關係,我找她打架了。從遠裏說跟韓東有關係。</s>	angry	angry
<s> “咋能沒關係?從近裏說跟我有關係,我找她打架了。從遠裏說跟韓東有關係。 </s></s> 行。你倆在這值班吧,我跟韓東去找。</s>	neutral	neutral
<s></s></s> 不用,明天我就不過來了,和韓東去找人。</s>	neutral	neutral
<s> 不用,明天我就不過來了,和韓東去找人。 </s></s> 也行。</s>	joy	neutral
<s></s></s> 你倆咋來了?叔叔的情況怎麼樣?</s>	fear	fear
<s> 你倆咋來了?叔叔的情況怎麼樣? </s></s> 他挺好,能直起腰,能下地走路了。</s>	joy	joy
<s> 你倆咋來了?叔叔的情況怎麼樣? 他挺好,能直起腰,能下地走路了。 </s></s> 那就好,不能着急,傷筋動骨一百天,慢慢養吧。</s>	neutral	joy
<s></s></s> 我們想問問,前幾天這裏住過一個病人吧,她上哪去了?</s>	neutral	surprise
<s> 我們想問問,前幾天這裏住過一個病人吧,她上哪去了? </s></s> 這裏住的人多了。你問什麼病人?叫什麼名字?</s>	surprise	surprise
<s></s></s> 產婦,作人工流產的,叫徐麗。</s>	neutral	neutral
<s> 產婦,作人工流產的,叫徐麗。 </s></s> 徐麗?她走了。</s>	surprise	surprise
<s></s></s> 上哪兒去了?</s>	surprise	surprise
<s> 上哪兒去了? </s></s> 誰知道她上哪兒去了?走的時候也沒跟我們說,是自個兒偷着走的。</s>	sadness	angry
<s></s></s> 我們也不知道她上醫院來了。後來她從醫院出來也沒回家,我們這才知道,也不知道她上哪兒去了。</s>	sadness	fear
<s> 我們也不知道她上醫院來了。後來她從醫院出來也沒回家,我們這才知道,也不知道她上哪兒去了。 </s></s> 她住院那幾天沒跟什麼人接觸過嗎?</s>	surprise	surprise
<s> 我們也不知道她上醫院來了。後來她從醫院出來也沒回家,我們這才知道,也不知道她上哪兒去了。 她住院那幾天沒跟什麼人接觸過嗎? </s></s> “沒有。</s>	neutral	neutral
<s></s></s> 能肯定是狗剩子嗎?</s>	fear	fear
<s> 能肯定是狗剩子嗎? </s></s> 肯定是!那小子一向不老實,偷雞摸狗,啥事都幹得出來。</s>	disgust	angry
<s> 能肯定是狗剩子嗎? 肯定是!那小子一向不老實,偷雞摸狗,啥事都幹得出來。 </s></s> 他能把徐麗怎麼樣呢?</s>	angry	fear
<s> 能肯定是狗剩子嗎? 肯定是!那小子一向不老實,偷雞摸狗,啥事都幹得出來。 他能把徐麗怎麼樣呢? </s></s> 佔點便宜唄,他還敢怎麼樣?</s>	angry	angry
<s> 能肯定是狗剩子嗎? 肯定是!那小子一向不老實,偷雞摸狗,啥事都幹得出來。 他能把徐麗怎麼樣呢? 佔點便宜唄,他還敢怎麼樣? </s></s> 徐麗還不至於就給他佔便宜吧?</s>	joy	fear
<s> 能肯定是狗剩子嗎? 肯定是!那小子一向不老實,偷雞摸狗,啥事都幹得出來。 他能把徐麗怎麼樣呢? 佔點便宜唄,他還敢怎麼樣? 徐麗還不至於就給他佔便宜吧? </s></s> 那可難說,他乘人之危呀。那小子常在這條路上跑嗎?</s>	surprise	angry
<s> 能肯定是狗剩子嗎? 肯定是!那小子一向不老實,偷雞摸狗,啥事都幹得出來。 他能把徐麗怎麼樣呢? 佔點便宜唄,他還敢怎麼樣? 徐麗還不至於就給他佔便宜吧? 那可難說,他乘人之危呀。那小子常在這條路上跑嗎? </s></s> 他一個手扶還能上哪兒?就在這條路上唄。</s>	neutral	angry
<s> 能肯定是狗剩子嗎? 肯定是!那小子一向不老實,偷雞摸狗,啥事都幹得出來。 他能把徐麗怎麼樣呢? 佔點便宜唄,他還敢怎麼樣? 徐麗還不至於就給他佔便宜吧? 那可難說,他乘人之危呀。那小子常在這條路上跑嗎? 他一個手扶還能上哪兒?就在這條路上唄。 </s></s> 你見過他?</s>	surprise	surprise
<s> 能肯定是狗剩子嗎? 肯定是!那小子一向不老實,偷雞摸狗,啥事都幹得出來。 他能把徐麗怎麼樣呢? 佔點便宜唄,他還敢怎麼樣? 徐麗還不至於就給他佔便宜吧? 那可難說,他乘人之危呀。那小子常在這條路上跑嗎? 他一個手扶還能上哪兒?就在這條路上唄。 你見過他? </s></s> 以前常見,最近沒見。</s>	neutral	neutral
<s> 能肯定是狗剩子嗎? 肯定是!那小子一向不老實,偷雞摸狗,啥事都幹得出來。 他能把徐麗怎麼樣呢? 佔點便宜唄,他還敢怎麼樣? 徐麗還不至於就給他佔便宜吧? 那可難說,他乘人之危呀。那小子常在這條路上跑嗎? 他一個手扶還能上哪兒?就在這條路上唄。 你見過他? 以前常見,最近沒見。 </s></s> 在路上截不到,就上青河去堵,跑不了他。</s>	neutral	angry
<s></s></s> 看來徐麗是出走了。</s>	neutral	neutral
<s> 看來徐麗是出走了。 </s></s> 對。可她能上哪去呢?</s>	fear	fear
<s></s></s> 肯定是離開景陽鎮了。白鴿真不該去收拾她。</s>	neutral	sadness
<s> 肯定是離開景陽鎮了。白鴿真不該去收拾她。 </s></s> 敲打敲打她也對,省得她太囂張。</s>	neutral	disgust
<s></s></s> 這個情況她們家可能還不知道,是不是應該跟她們家說一下?</s>	fear	fear
<s> 這個情況她們家可能還不知道,是不是應該跟她們家說一下? </s></s> 是應該跟他們說一說,告訴他們徐麗出門了,沒什麼事兒,省得他們着急。可這事咱們怎麼說?</s>	neutral	fear
<s></s></s> 最好狗剩子去說,他是直接見證人。</s>	neutral	angry
<s> 最好狗剩子去說,他是直接見證人。 </s></s> 狗剩子能去嗎?</s>	surprise	fear
<s></s></s> 叫白鴿去吧,就說她看見狗剩子了,是狗剩子跟她說的。</s>	neutral	neutral
<s> 叫白鴿去吧,就說她看見狗剩子了,是狗剩子跟她說的。 </s></s> 也好,叫曉華跟白鴿一塊去,她們都認識狗剩子。徐麗他們家要不信,就直接去找狗剩子。</s>	neutral	neutral
<s> 叫白鴿去吧,就說她看見狗剩子了,是狗剩子跟她說的。 也好,叫曉華跟白鴿一塊去,她們都認識狗剩子。徐麗他們家要不信,就直接去找狗剩子。 </s></s> 對,這樣好。</s>	joy	neutral
<s></s></s> 這廣告還真是沒白作,最近客戶明顯增加了。</s>	joy	joy
<s> 這廣告還真是沒白作,最近客戶明顯增加了。 </s></s> 照這樣做,咱們年底前就能把馬軍欠的錢掙出來。</s>	joy	joy
<s> 這廣告還真是沒白作,最近客戶明顯增加了。 照這樣做,咱們年底前就能把馬軍欠的錢掙出來。 </s></s> 掙出來我也不還給他,先在我手裏攢着,攢熱了再給他。</s>	joy	joy
<s> 這廣告還真是沒白作,最近客戶明顯增加了。 照這樣做,咱們年底前就能把馬軍欠的錢掙出來。 掙出來我也不還給他,先在我手裏攢着,攢熱了再給他。 </s></s> 對。你爸不是說了嗎?他跟局長說好了,可以不受三個月的時間限制,拖的時間長一點也沒關係,</s>	joy	joy
<s> 這廣告還真是沒白作,最近客戶明顯增加了。 照這樣做,咱們年底前就能把馬軍欠的錢掙出來。 掙出來我也不還給他,先在我手裏攢着,攢熱了再給他。 對。你爸不是說了嗎?他跟局長說好了,可以不受三個月的時間限制,拖的時間長一點也沒關係, </s></s> 讓咱們也過過錢癮,看看有錢是啥滋味,這沒錢的日子是難過呀。</s>	joy	joy
<s> 這廣告還真是沒白作,最近客戶明顯增加了。 照這樣做,咱們年底前就能把馬軍欠的錢掙出來。 掙出來我也不還給他,先在我手裏攢着,攢熱了再給他。 對。你爸不是說了嗎?他跟局長說好了,可以不受三個月的時間限制,拖的時間長一點也沒關係, 讓咱們也過過錢癮,看看有錢是啥滋味,這沒錢的日子是難過呀。 </s></s> 美玉不是說她爸要把廠子賣了給馬軍還錢嗎?</s>	surprise	surprise
<s> 這廣告還真是沒白作,最近客戶明顯增加了。 照這樣做,咱們年底前就能把馬軍欠的錢掙出來。 掙出來我也不還給他,先在我手裏攢着,攢熱了再給他。 對。你爸不是說了嗎?他跟局長說好了,可以不受三個月的時間限制,拖的時間長一點也沒關係, 讓咱們也過過錢癮,看看有錢是啥滋味,這沒錢的日子是難過呀。 美玉不是說她爸要把廠子賣了給馬軍還錢嗎? </s></s> 說是說,還真賣呀?</s>	joy	surprise
<s> 這廣告還真是沒白作,最近客戶明顯增加了。 照這樣做,咱們年底前就能把馬軍欠的錢掙出來。 掙出來我也不還給他,先在我手裏攢着,攢熱了再給他。 對。你爸不是說了嗎?他跟局長說好了,可以不受三個月的時間限制,拖的時間長一點也沒關係, 讓咱們也過過錢癮,看看有錢是啥滋味,這沒錢的日子是難過呀。 美玉不是說她爸要把廠子賣了給馬軍還錢嗎? 說是說,還真賣呀? </s></s> 人家電話都打過去了嘛。</s>	joy	fear
<s> 這廣告還真是沒白作,最近客戶明顯增加了。 照這樣做,咱們年底前就能把馬軍欠的錢掙出來。 掙出來我也不還給他,先在我手裏攢着,攢熱了再給他。 對。你爸不是說了嗎?他跟局長說好了,可以不受三個月的時間限制,拖的時間長一點也沒關係, 讓咱們也過過錢癮,看看有錢是啥滋味,這沒錢的日子是難過呀。 美玉不是說她爸要把廠子賣了給馬軍還錢嗎? 說是說,還真賣呀? 人家電話都打過去了嘛。 </s></s> 這不會是假的。因爲現在的馬軍不是從前的馬軍了。從前的馬軍跟他們沒關係,現在是人家的兒子了,人家能不管嗎?</s>	neutral	disgust
<s> 這廣告還真是沒白作,最近客戶明顯增加了。 照這樣做,咱們年底前就能把馬軍欠的錢掙出來。 掙出來我也不還給他,先在我手裏攢着,攢熱了再給他。 對。你爸不是說了嗎?他跟局長說好了,可以不受三個月的時間限制,拖的時間長一點也沒關係, 讓咱們也過過錢癮,看看有錢是啥滋味,這沒錢的日子是難過呀。 美玉不是說她爸要把廠子賣了給馬軍還錢嗎? 說是說,還真賣呀? 人家電話都打過去了嘛。 這不會是假的。因爲現在的馬軍不是從前的馬軍了。從前的馬軍跟他們沒關係,現在是人家的兒子了,人家能不管嗎? </s></s> 可是馬軍還沒去認他的親爸親媽呢。</s>	neutral	surprise
<s> 這廣告還真是沒白作,最近客戶明顯增加了。 照這樣做,咱們年底前就能把馬軍欠的錢掙出來。 掙出來我也不還給他,先在我手裏攢着,攢熱了再給他。 對。你爸不是說了嗎?他跟局長說好了,可以不受三個月的時間限制,拖的時間長一點也沒關係, 讓咱們也過過錢癮,看看有錢是啥滋味,這沒錢的日子是難過呀。 美玉不是說她爸要把廠子賣了給馬軍還錢嗎? 說是說,還真賣呀? 人家電話都打過去了嘛。 這不會是假的。因爲現在的馬軍不是從前的馬軍了。從前的馬軍跟他們沒關係,現在是人家的兒子了,人家能不管嗎? 可是馬軍還沒去認他的親爸親媽呢。 </s></s> 你爲啥還不認呢?</s>	surprise	surprise
<s> 照這樣做,咱們年底前就能把馬軍欠的錢掙出來。 掙出來我也不還給他,先在我手裏攢着,攢熱了再給他。 對。你爸不是說了嗎?他跟局長說好了,可以不受三個月的時間限制,拖的時間長一點也沒關係, 讓咱們也過過錢癮,看看有錢是啥滋味,這沒錢的日子是難過呀。 美玉不是說她爸要把廠子賣了給馬軍還錢嗎? 說是說,還真賣呀? 人家電話都打過去了嘛。 這不會是假的。因爲現在的馬軍不是從前的馬軍了。從前的馬軍跟他們沒關係,現在是人家的兒子了,人家能不管嗎? 可是馬軍還沒去認他的親爸親媽呢。 你爲啥還不認呢? </s></s> 我媽說,應該先作個親子鑑定。</s>	neutral	neutral
<s> 掙出來我也不還給他,先在我手裏攢着,攢熱了再給他。 對。你爸不是說了嗎?他跟局長說好了,可以不受三個月的時間限制,拖的時間長一點也沒關係, 讓咱們也過過錢癮,看看有錢是啥滋味,這沒錢的日子是難過呀。 美玉不是說她爸要把廠子賣了給馬軍還錢嗎? 說是說,還真賣呀? 人家電話都打過去了嘛。 這不會是假的。因爲現在的馬軍不是從前的馬軍了。從前的馬軍跟他們沒關係,現在是人家的兒子了,人家能不管嗎? 可是馬軍還沒去認他的親爸親媽呢。 你爲啥還不認呢? 我媽說,應該先作個親子鑑定。 </s></s> 作唄!那還不容易?</s>	joy	surprise
<s> 對。你爸不是說了嗎?他跟局長說好了,可以不受三個月的時間限制,拖的時間長一點也沒關係, 讓咱們也過過錢癮,看看有錢是啥滋味,這沒錢的日子是難過呀。 美玉不是說她爸要把廠子賣了給馬軍還錢嗎? 說是說,還真賣呀? 人家電話都打過去了嘛。 這不會是假的。因爲現在的馬軍不是從前的馬軍了。從前的馬軍跟他們沒關係,現在是人家的兒子了,人家能不管嗎? 可是馬軍還沒去認他的親爸親媽呢。 你爲啥還不認呢? 我媽說,應該先作個親子鑑定。 作唄!那還不容易? </s></s> “我這邊容易,誰知道韓東他爸願不願意作?</s>	neutral	disgust
<s></s></s> 應該願意作,比你還願意作。</s>	joy	neutral
<s> 應該願意作,比你還願意作。 </s></s> 那可不一定,聽說要抽血,可能就不願意了。</s>	fear	disgust
<s> 應該願意作,比你還願意作。 那可不一定,聽說要抽血,可能就不願意了。 </s></s> 你跟韓東說了嗎?</s>	surprise	fear
<s> 應該願意作,比你還願意作。 那可不一定,聽說要抽血,可能就不願意了。 你跟韓東說了嗎? </s></s> 說了。</s>	neutral	neutral
<s> 應該願意作,比你還願意作。 那可不一定,聽說要抽血,可能就不願意了。 你跟韓東說了嗎? 說了。 </s></s> 光說不行,你得催着點,要不得拖到啥時候?</s>	angry	surprise
<s> 應該願意作,比你還願意作。 那可不一定,聽說要抽血,可能就不願意了。 你跟韓東說了嗎? 說了。 光說不行,你得催着點,要不得拖到啥時候? </s></s> 別光說我的事,你也該給你的親爸盡盡孝心了吧?</s>	disgust	neutral
<s> 應該願意作,比你還願意作。 那可不一定,聽說要抽血,可能就不願意了。 你跟韓東說了嗎? 說了。 光說不行,你得催着點,要不得拖到啥時候? 別光說我的事,你也該給你的親爸盡盡孝心了吧? </s></s> 我的親爸?</s>	surprise	surprise
<s> 應該願意作,比你還願意作。 那可不一定,聽說要抽血,可能就不願意了。 你跟韓東說了嗎? 說了。 光說不行,你得催着點,要不得拖到啥時候? 別光說我的事,你也該給你的親爸盡盡孝心了吧? 我的親爸? </s></s> 對呀,我爸不也是你的親爸嗎?</s>	joy	surprise
<s> 應該願意作,比你還願意作。 那可不一定,聽說要抽血,可能就不願意了。 你跟韓東說了嗎? 說了。 光說不行,你得催着點,要不得拖到啥時候? 別光說我的事,你也該給你的親爸盡盡孝心了吧? 我的親爸? 對呀,我爸不也是你的親爸嗎? </s></s> 盡不盡孝心先不說,去看看是應該的。</s>	neutral	neutral
<s> 應該願意作,比你還願意作。 那可不一定,聽說要抽血,可能就不願意了。 你跟韓東說了嗎? 說了。 光說不行,你得催着點,要不得拖到啥時候? 別光說我的事,你也該給你的親爸盡盡孝心了吧? 我的親爸? 對呀,我爸不也是你的親爸嗎? 盡不盡孝心先不說,去看看是應該的。 </s></s> “就是,趁着現在沒事上趟我們家,見見我爸,</s>	joy	joy
<s></s></s> 爺爺!我曉華姐來看您了!</s>	joy	joy
<s> 爺爺!我曉華姐來看您了! </s></s> 曉華?噢,小花!</s>	joy	surprise
<s></s></s> 爺爺!</s>	surprise	joy
<s> 爺爺! </s></s> 小花!小花姑娘,長這麼高了!</s>	joy	joy
<s></s></s> 爺爺,您生日快樂!</s>	joy	joy
<s> 爺爺,您生日快樂! </s></s> 啊?生日快樂!生日快樂!你怎麼知道我過生日呀?</s>	surprise	joy
<s></s></s> 是小軍跟我說的。</s>	neutral	joy
<s> 是小軍跟我說的。 </s></s> 小軍哪,難爲你還記得我的生日。快坐,快坐下!</s>	surprise	joy
<s></s></s> 馬爺爺!</s>	surprise	joy
<s> 馬爺爺! </s></s> 你是小白姑娘?</s>	surprise	surprise
<s></s></s> 是,馬爺爺生日快樂!</s>	joy	joy
<s> 是,馬爺爺生日快樂! </s></s> 生日快樂,謝謝你。</s>	joy	joy
<s></s></s> 我爸我媽呢?</s>	surprise	surprise
<s> 我爸我媽呢? </s></s> 你爸上班,你媽上街了。</s>	neutral	neutral
<s></s></s> 今天星期天還上班?</s>	surprise	surprise
<s> 今天星期天還上班? </s></s> 他什麼時候休過星期天哪?小花姑娘好久沒上家裏來了吧?</s>	surprise	joy
<s></s></s> 是,好像還從來沒來過呢。</s>	surprise	surprise
<s> 是,好像還從來沒來過呢。 </s></s> 是呀,一晃這都二、三十年了,你都長成大姑娘了,我們也都老了。</s>	sadness	sadness
<s></s></s> 爺爺,我沒孝敬您,我對不住您。</s>	sadness	sadness
<s> 爺爺,我沒孝敬您,我對不住您。 </s></s> 也別這麼說,都不容易,你能孝敬你小姨也是好的。</s>	joy	joy
<s></s></s> 這次韓東他大爺回來,說了小軍的事,我們都覺得老人們一輩子拉扯孩子太難,太不容易了。要是沒有老人們,哪還能有我們呀?我們作小輩的,應該永遠感謝你們,孝敬你們。</s>	joy	joy
<s> 這次韓東他大爺回來,說了小軍的事,我們都覺得老人們一輩子拉扯孩子太難,太不容易了。要是沒有老人們,哪還能有我們呀?我們作小輩的,應該永遠感謝你們,孝敬你們。 </s></s> 是呀。我聽說小軍要去看他的親爸親媽,怎麼還沒去呢?應該去,不光要看,還要認。那是你的親爸親媽,沒有他們就沒有你。你要永遠孝敬他們。</s>	joy	joy
<s></s></s> 是,爺爺。曉華姐今天來,也是來認她的親爸的。</s>	joy	joy
<s> 是,爺爺。曉華姐今天來,也是來認她的親爸的。 </s></s> 是嗎?</s>	surprise	surprise
<s></s></s> 是的,爺爺。</s>	neutral	joy
<s> 是的,爺爺。 </s></s> 唉,孩子都長這麼大了。他這個作爸爸的,也沒盡什麼責任。</s>	sadness	sadness
<s></s></s> 不是的,爺爺,爸爸給我們幫了不少忙呢。</s>	joy	joy
<s> 不是的,爺爺,爸爸給我們幫了不少忙呢。 </s></s> 其實曉華姐跟我的情況還是不一樣的。我根本就不知道我的親爸親媽是誰。她不是不知道,就是來往少,像兩家人似的。</s>	sadness	sadness
<s></s></s> 對,本來是一家人,就是彼此沒來往,以後多來往,多走動走動就好了。</s>	joy	joy
<s> 對,本來是一家人,就是彼此沒來往,以後多來往,多走動走動就好了。 </s></s> 對,本來就是一家人嘛,不存在什麼認不認的。</s>	joy	joy
<s></s></s> 爺爺,您知道我小姨爲啥那麼恨我爸嗎?</s>	sadness	surprise
<s> 爺爺,您知道我小姨爲啥那麼恨我爸嗎? </s></s> 唉,年輕人,不知道珍惜呀。你媽,小滿是個多好的姑娘,那麼年輕就沒了。要說你爸不喜歡小滿,那是假的。那時候,我們給他說了多少個人,他都看不上,就喜歡小滿,說非小滿不娶,那就娶小滿吧。娶了小滿,正趕上生活困難,吃不飽,工作又累,小滿又懷了孕,沒有營養,人頂不住,可在這關鍵的時候,你爸又沒好好伺候她,沒把她保護好......</s>	sadness	sadness
<s></s></s> 我二姨也是那時候死的?</s>	surprise	surprise
<s> 我二姨也是那時候死的? </s></s> 唉,困難哪!吃不飽是要死人的......</s>	sadness	sadness
<s></s></s> 寶林這個熊孩子也不知上哪去了。他老婆要生了也不見他個人影兒。老趙,咱倆分頭去找找他,你上厂部,我上他家裏去。</s>	neutral	surprise
<s> 寶林這個熊孩子也不知上哪去了。他老婆要生了也不見他個人影兒。老趙,咱倆分頭去找找他,你上厂部,我上他家裏去。 </s></s> 你們看見小馬了嗎,馬寶林?</s>	surprise	surprise
<s></s></s> 爹!</s>	surprise	surprise
<s> 爹! </s></s> 你們幹啥呢?</s>	surprise	angry
<s> 爹! 你們幹啥呢? </s></s> 扒一點青苞米。</s>	neutral	neutral
<s> 爹! 你們幹啥呢? 扒一點青苞米。 </s></s> “你老婆要生孩子了,你咋還待在家裏不上醫務所去?小滿咋樣了你知道嗎?</s>	angry	angry
<s></s></s> 你媽和你二姨一走,就剩下你小姨了,那時候她還小,多虧了你老姥姥還在,她帶着你。你姥姥一走,就全靠你小姨了,她不容易呀。別怪你小姨恨你爸,她恨也是應該的。都怪你爸,在你們最困難的時候他沒伸手幫忙。他當時想把你要過去,你小姨不給。你爸就不理你小姨。你小姨爲啥不給?這你爸應該理解。其實你小姨一個人帶着你,她多困難?她不希望有人幫她一把嗎?在這一點上你爸做得不對。</s>	sadness	sadness
<s> 你媽和你二姨一走,就剩下你小姨了,那時候她還小,多虧了你老姥姥還在,她帶着你。你姥姥一走,就全靠你小姨了,她不容易呀。別怪你小姨恨你爸,她恨也是應該的。都怪你爸,在你們最困難的時候他沒伸手幫忙。他當時想把你要過去,你小姨不給。你爸就不理你小姨。你小姨爲啥不給?這你爸應該理解。其實你小姨一個人帶着你,她多困難?她不希望有人幫她一把嗎?在這一點上你爸做得不對。 </s></s> 所以後來我爸就儘量幫我小姨。</s>	neutral	sadness
<s> 你媽和你二姨一走,就剩下你小姨了,那時候她還小,多虧了你老姥姥還在,她帶着你。你姥姥一走,就全靠你小姨了,她不容易呀。別怪你小姨恨你爸,她恨也是應該的。都怪你爸,在你們最困難的時候他沒伸手幫忙。他當時想把你要過去,你小姨不給。你爸就不理你小姨。你小姨爲啥不給?這你爸應該理解。其實你小姨一個人帶着你,她多困難?她不希望有人幫她一把嗎?在這一點上你爸做得不對。 所以後來我爸就儘量幫我小姨。 </s></s> 幫一幫是應該的,就是有點晚了。</s>	neutral	sadness
<s></s></s> 也不晚,現在幫忙才解決大問題呢。</s>	joy	joy
<s> 也不晚,現在幫忙才解決大問題呢。 </s></s> 現在要解決的是什麼問題?是吃飯問題嗎?是生存問題嗎?什麼是大問題?這纔是大問題!現在的問題是想發財發不了,想賺大錢賺不來,這算什麼問題?你們放着國企的工作不做,看不上鐵飯碗,去倒騰木材,開飯店,開髮廊。你們也有困難,這種困難能跟那時候的困難相比嗎?</s>	sadness	angry
<s></s></s> 馬爺爺說得對。</s>	neutral	neutral
<s> 馬爺爺說得對。 </s></s> 說一千道一萬,現在是趕上好時候了。過去的人,過去的事就別想了,過好現在的日子纔是正經。</s>	joy	neutral
<s></s></s> 對,團結一致向前看,曉華姐這不就來了嘛。</s>	joy	joy
<s> 對,團結一致向前看,曉華姐這不就來了嘛。 </s></s> 嗯,來了就好。</s>	joy	joy
<s></s></s> 大娘!崔順子大娘!</s>	surprise	surprise
<s> 大娘!崔順子大娘! </s></s> 是叫我嗎?</s>	surprise	surprise
<s> 大娘!崔順子大娘! 是叫我嗎? </s></s> 是的。大娘,我是鎮政府的。我來找過您。</s>	joy	surprise
<s></s></s> 噢,有事嗎?</s>	surprise	surprise
<s> 噢,有事嗎? </s></s> 大娘,我來通知您,您有一筆匯款,在鎮政府,您去取一下。</s>	neutral	neutral
<s></s></s> 匯款?</s>	surprise	surprise
<s> 匯款? </s></s> 是的,匯款。</s>	joy	neutral
<s></s></s> 匯款是啥?</s>	surprise	surprise
<s> 匯款是啥? </s></s> 匯款就是有人從外地給您匯來了一筆錢。</s>	joy	neutral
<s></s></s> 一筆錢?</s>	surprise	surprise
<s> 一筆錢? </s></s> 對。</s>	neutral	neutral
<s> 一筆錢? 對。 </s></s> 一筆錢?多少錢?</s>	surprise	surprise
<s> 一筆錢? 對。 一筆錢?多少錢? </s></s> 八萬。</s>	neutral	neutral
<s> 一筆錢? 對。 一筆錢?多少錢? 八萬。 </s></s> 八萬?</s>	surprise	surprise
<s> 一筆錢? 對。 一筆錢?多少錢? 八萬。 八萬? </s></s> 是的,八萬。</s>	joy	neutral
<s> 一筆錢? 對。 一筆錢?多少錢? 八萬。 八萬? 是的,八萬。 </s></s> 給我們匯來八萬塊錢?</s>	surprise	surprise
<s> 一筆錢? 對。 一筆錢?多少錢? 八萬。 八萬? 是的,八萬。 給我們匯來八萬塊錢? </s></s> 是的。</s>	neutral	neutral
<s> 一筆錢? 對。 一筆錢?多少錢? 八萬。 八萬? 是的,八萬。 給我們匯來八萬塊錢? 是的。 </s></s> 是哪兒匯來的?誰匯來的?</s>	surprise	surprise
<s> 一筆錢? 對。 一筆錢?多少錢? 八萬。 八萬? 是的,八萬。 給我們匯來八萬塊錢? 是的。 是哪兒匯來的?誰匯來的? </s></s> 是從南朝鮮匯來的,誰匯的不清楚,去看看匯款單就知道了。</s>	neutral	neutral
<s> 一筆錢? 對。 一筆錢?多少錢? 八萬。 八萬? 是的,八萬。 給我們匯來八萬塊錢? 是的。 是哪兒匯來的?誰匯來的? 是從南朝鮮匯來的,誰匯的不清楚,去看看匯款單就知道了。 </s></s> 南朝鮮?那就是我哥了!我哥匯來的!</s>	joy	joy
<s></s></s> 長林?他給咱們匯款了?</s>	surprise	surprise
<s> 長林?他給咱們匯款了? </s></s> 肯定是他!不是他還能有誰?</s>	angry	joy
<s></s></s> 他給咱們匯款幹啥?</s>	surprise	surprise
<s> 他給咱們匯款幹啥? </s></s> 匯款肯定有用處唄。他給匯了多少?</s>	joy	surprise
<s> 他給咱們匯款幹啥? 匯款肯定有用處唄。他給匯了多少? </s></s> 八萬。</s>	neutral	neutral
<s></s></s> 八萬是多少?</s>	neutral	surprise
<s> 八萬是多少? </s></s> 八萬就是八萬。</s>	joy	neutral
<s> 八萬是多少? 八萬就是八萬。 </s></s> 八萬就八萬吧。咱們就去取吧,在哪兒取?</s>	joy	surprise
<s> 八萬是多少? 八萬就是八萬。 八萬就八萬吧。咱們就去取吧,在哪兒取? </s></s> 在鎮政府。</s>	neutral	neutral
<s> 八萬是多少? 八萬就是八萬。 八萬就八萬吧。咱們就去取吧,在哪兒取? 在鎮政府。 </s></s> 那好吧,咱們這就去。</s>	joy	neutral
<s> 八萬是多少? 八萬就是八萬。 八萬就八萬吧。咱們就去取吧,在哪兒取? 在鎮政府。 那好吧,咱們這就去。 </s></s> 要帶上您的身份證和戶口本。</s>	neutral	neutral
<s> 八萬是多少? 八萬就是八萬。 八萬就八萬吧。咱們就去取吧,在哪兒取? 在鎮政府。 那好吧,咱們這就去。 要帶上您的身份證和戶口本。 </s></s> 行。</s>	joy	neutral
<s></s></s> 等等!</s>	neutral	surprise
<s> 等等! </s></s> 幹啥?</s>	surprise	surprise
<s></s></s> 你去把東子叫上,讓他跟你去。你糊里糊塗的知道啥?</s>	angry	surprise
<s> 你去把東子叫上,讓他跟你去。你糊里糊塗的知道啥? </s></s> 也行。</s>	neutral	neutral
<s></s></s> 你要找的人在哪兒?</s>	surprise	surprise
<s> 你要找的人在哪兒? </s></s> 我知道他在哪兒。</s>	neutral	neutral
<s> 你要找的人在哪兒? 我知道他在哪兒。 </s></s> 你找到他以後就到這裏來取款。</s>	neutral	neutral
<s> 你要找的人在哪兒? 我知道他在哪兒。 你找到他以後就到這裏來取款。 </s></s> 我知道。</s>	neutral	neutral
<s></s></s> 爸,你怎麼來了?</s>	surprise	surprise
<s> 爸,你怎麼來了? </s></s> 有事?</s>	surprise	surprise
<s></s></s> 啥事?</s>	surprise	surprise
<s> 啥事? </s></s> 跟我上鎮政府取錢。</s>	neutral	neutral
<s></s></s> 上鎮政府取錢?上鎮政府取啥錢?</s>	angry	surprise
<s> 上鎮政府取錢?上鎮政府取啥錢? </s></s> 你大爺匯來的錢。</s>	neutral	neutral
<s></s></s> 我大爺匯錢來了?</s>	surprise	surprise
<s> 我大爺匯錢來了? </s></s> 是呀,匯來了八萬呢!</s>	joy	joy
<s></s></s> 匯來了八萬?</s>	surprise	surprise
<s> 匯來了八萬? </s></s> 是呀,匯來了八萬。剛纔政府的幹部上家裏來了通知咱們的。他說匯來了八萬。</s>	joy	neutral
<s></s></s> 還真給匯錢來了。</s>	joy	surprise
<s> 還真給匯錢來了。 </s></s> 你都知道了?</s>	surprise	surprise
<s></s></s> 我大爺走的時候說過,他要給咱們匯點錢過來。</s>	neutral	neutral
<s> 我大爺走的時候說過,他要給咱們匯點錢過來。 </s></s> 他給咱們匯錢幹啥?</s>	surprise	surprise
<s></s></s> 他說咱們生活困難,幫幫咱們。</s>	neutral	neutral
<s> 他說咱們生活困難,幫幫咱們。 </s></s> 那不挺好嗎?咱們這就去取吧。</s>	joy	joy
<s></s></s> 不對,幫咱們生活困難也用不了這麼多錢呀。</s>	surprise	surprise
<s> 不對,幫咱們生活困難也用不了這麼多錢呀。 </s></s> 那他匯這麼多錢幹啥?</s>	surprise	surprise
<s></s></s> 肯定是給馬軍還帳的。</s>	neutral	neutral
<s> 肯定是給馬軍還帳的。 </s></s> “</s>	neutral	neutral
<s></s></s> 他們走之前美玉說過,我大爺準備把他的工廠賣掉,幫馬軍還帳。</s>	neutral	neutral
<s> 他們走之前美玉說過,我大爺準備把他的工廠賣掉,幫馬軍還帳。 </s></s> 你說些啥?我怎麼聽不明白?</s>	surprise	surprise
<s></s></s> 我詳細跟您說說就明白了,咱們先回家。</s>	neutral	neutral
<s> 我詳細跟您說說就明白了,咱們先回家。 </s></s> 回家?</s>	surprise	surprise
<s></s></s> 肚臍眼旁邊有一顆痣?這可太特別了!</s>	surprise	surprise
<s> 肚臍眼旁邊有一顆痣?這可太特別了! </s></s> 是呀,問問他自己就知道了,他要是有,就是我的孩子;要沒有,就跟我沒關係。</s>	joy	neutral
<s> 肚臍眼旁邊有一顆痣?這可太特別了! 是呀,問問他自己就知道了,他要是有,就是我的孩子;要沒有,就跟我沒關係。 </s></s> 行!這很簡單,我見着他問問就行了,這樣錢的事也好辦了。他要是咱家的孩子,錢就給他用;他要不是咱家的孩子,錢也不用給他,還給我大爺退回去吧。這是我大爺賣工廠的錢。</s>	joy	neutral
<s> 肚臍眼旁邊有一顆痣?這可太特別了! 是呀,問問他自己就知道了,他要是有,就是我的孩子;要沒有,就跟我沒關係。 行!這很簡單,我見着他問問就行了,這樣錢的事也好辦了。他要是咱家的孩子,錢就給他用;他要不是咱家的孩子,錢也不用給他,還給我大爺退回去吧。這是我大爺賣工廠的錢。 </s></s> 這樣挺好。你啥時候去問呀?</s>	joy	surprise
<s> 肚臍眼旁邊有一顆痣?這可太特別了! 是呀,問問他自己就知道了,他要是有,就是我的孩子;要沒有,就跟我沒關係。 行!這很簡單,我見着他問問就行了,這樣錢的事也好辦了。他要是咱家的孩子,錢就給他用;他要不是咱家的孩子,錢也不用給他,還給我大爺退回去吧。這是我大爺賣工廠的錢。 這樣挺好。你啥時候去問呀? </s></s> 我現在就去。爸你就在家等着吧,需要取錢的時候我來接你。</s>	neutral	neutral
<s> 肚臍眼旁邊有一顆痣?這可太特別了! 是呀,問問他自己就知道了,他要是有,就是我的孩子;要沒有,就跟我沒關係。 行!這很簡單,我見着他問問就行了,這樣錢的事也好辦了。他要是咱家的孩子,錢就給他用;他要不是咱家的孩子,錢也不用給他,還給我大爺退回去吧。這是我大爺賣工廠的錢。 這樣挺好。你啥時候去問呀? 我現在就去。爸你就在家等着吧,需要取錢的時候我來接你。 </s></s> 行。</s>	neutral	neutral
<s></s></s> 總共一千八百三十五元。</s>	neutral	neutral
<s> 總共一千八百三十五元。 </s></s> 正好。</s>	joy	neutral
<s> 總共一千八百三十五元。 正好。 </s></s> 好,那我就走了,謝謝!</s>	joy	joy
<s> 總共一千八百三十五元。 正好。 好,那我就走了,謝謝! </s></s> 不用謝,開車慢點,歡迎再來!</s>	joy	joy
<s></s></s> 今天出去了幾個車?是最多的一天吧?</s>	surprise	surprise
<s> 今天出去了幾個車?是最多的一天吧? </s></s> 沒錯,今天把你們倆累壞了。</s>	sadness	joy
<s> 今天出去了幾個車?是最多的一天吧? 沒錯,今天把你們倆累壞了。 </s></s> 累也高興,天天這麼幹纔好呢。</s>	joy	joy
<s> 今天出去了幾個車?是最多的一天吧? 沒錯,今天把你們倆累壞了。 累也高興,天天這麼幹纔好呢。 </s></s> 這比火車發運好,雖然累一點,可是簡單,快,當時就見着錢了。火車發運麻煩不說,貨走了還不知道錢啥時候回來,心裏沒底。</s>	sadness	joy
<s> 今天出去了幾個車?是最多的一天吧? 沒錯,今天把你們倆累壞了。 累也高興,天天這麼幹纔好呢。 這比火車發運好,雖然累一點,可是簡單,快,當時就見着錢了。火車發運麻煩不說,貨走了還不知道錢啥時候回來,心裏沒底。 </s></s> 其實火車發運也不輕鬆,跑來跑去的多少趟,也夠累的。</s>	neutral	neutral
<s> 今天出去了幾個車?是最多的一天吧? 沒錯,今天把你們倆累壞了。 累也高興,天天這麼幹纔好呢。 這比火車發運好,雖然累一點,可是簡單,快,當時就見着錢了。火車發運麻煩不說,貨走了還不知道錢啥時候回來,心裏沒底。 其實火車發運也不輕鬆,跑來跑去的多少趟,也夠累的。 </s></s> 火車發運都是大頭,一來就是幾十方,那纔像個大公司的樣子。</s>	joy	joy
<s> 今天出去了幾個車?是最多的一天吧? 沒錯,今天把你們倆累壞了。 累也高興,天天這麼幹纔好呢。 這比火車發運好,雖然累一點,可是簡單,快,當時就見着錢了。火車發運麻煩不說,貨走了還不知道錢啥時候回來,心裏沒底。 其實火車發運也不輕鬆,跑來跑去的多少趟,也夠累的。 火車發運都是大頭,一來就是幾十方,那纔像個大公司的樣子。 </s></s> 你就想幹大公司,當大老闆。</s>	neutral	joy
<s> 今天出去了幾個車?是最多的一天吧? 沒錯,今天把你們倆累壞了。 累也高興,天天這麼幹纔好呢。 這比火車發運好,雖然累一點,可是簡單,快,當時就見着錢了。火車發運麻煩不說,貨走了還不知道錢啥時候回來,心裏沒底。 其實火車發運也不輕鬆,跑來跑去的多少趟,也夠累的。 火車發運都是大頭,一來就是幾十方,那纔像個大公司的樣子。 你就想幹大公司,當大老闆。 </s></s> 那是!誰不想幹大公司,當大老闆?</s>	joy	joy
<s> 今天出去了幾個車?是最多的一天吧? 沒錯,今天把你們倆累壞了。 累也高興,天天這麼幹纔好呢。 這比火車發運好,雖然累一點,可是簡單,快,當時就見着錢了。火車發運麻煩不說,貨走了還不知道錢啥時候回來,心裏沒底。 其實火車發運也不輕鬆,跑來跑去的多少趟,也夠累的。 火車發運都是大頭,一來就是幾十方,那纔像個大公司的樣子。 你就想幹大公司,當大老闆。 那是!誰不想幹大公司,當大老闆? </s></s> 彆着急,好好幹,有你當大老闆的時候。</s>	joy	joy
<s></s></s> 你們等好消息吧!不過咱們還得再接再厲,多掙錢快掙錢,掙錢還帳!</s>	joy	joy
<s> 你們等好消息吧!不過咱們還得再接再厲,多掙錢快掙錢,掙錢還帳! </s></s> 你媽是那樣說的嗎?說她孩子的身上有一顆痣?</s>	angry	surprise
<s> 你們等好消息吧!不過咱們還得再接再厲,多掙錢快掙錢,掙錢還帳! 你媽是那樣說的嗎?說她孩子的身上有一顆痣? </s></s> 這還有錯嗎?我跟我爸媽說去作親子鑑定。我媽就說不用鑑定,她的孩子身上有記號,孩子的肚臍眼旁邊有一顆痣。</s>	fear	neutral
<s> 你們等好消息吧!不過咱們還得再接再厲,多掙錢快掙錢,掙錢還帳! 你媽是那樣說的嗎?說她孩子的身上有一顆痣? 這還有錯嗎?我跟我爸媽說去作親子鑑定。我媽就說不用鑑定,她的孩子身上有記號,孩子的肚臍眼旁邊有一顆痣。 </s></s> 肚臍眼旁邊有一顆痣?</s>	surprise	surprise
<s> 你們等好消息吧!不過咱們還得再接再厲,多掙錢快掙錢,掙錢還帳! 你媽是那樣說的嗎?說她孩子的身上有一顆痣? 這還有錯嗎?我跟我爸媽說去作親子鑑定。我媽就說不用鑑定,她的孩子身上有記號,孩子的肚臍眼旁邊有一顆痣。 肚臍眼旁邊有一顆痣? </s></s> 是呀,你的肚臍眼旁邊有痣嗎?</s>	surprise	surprise
<s> 你們等好消息吧!不過咱們還得再接再厲,多掙錢快掙錢,掙錢還帳! 你媽是那樣說的嗎?說她孩子的身上有一顆痣? 這還有錯嗎?我跟我爸媽說去作親子鑑定。我媽就說不用鑑定,她的孩子身上有記號,孩子的肚臍眼旁邊有一顆痣。 肚臍眼旁邊有一顆痣? 是呀,你的肚臍眼旁邊有痣嗎? </s></s> 有啊!我的肚臍眼旁邊就是有一顆痣呀,是胎裏帶來的!可是她怎麼知道?</s>	surprise	surprise
<s> 你們等好消息吧!不過咱們還得再接再厲,多掙錢快掙錢,掙錢還帳! 你媽是那樣說的嗎?說她孩子的身上有一顆痣? 這還有錯嗎?我跟我爸媽說去作親子鑑定。我媽就說不用鑑定,她的孩子身上有記號,孩子的肚臍眼旁邊有一顆痣。 肚臍眼旁邊有一顆痣? 是呀,你的肚臍眼旁邊有痣嗎? 有啊!我的肚臍眼旁邊就是有一顆痣呀,是胎裏帶來的!可是她怎麼知道? </s></s> 她怎麼不知道?我爸也知道,他倆都這麼說的。</s>	surprise	neutral
<s> 你們等好消息吧!不過咱們還得再接再厲,多掙錢快掙錢,掙錢還帳! 你媽是那樣說的嗎?說她孩子的身上有一顆痣? 這還有錯嗎?我跟我爸媽說去作親子鑑定。我媽就說不用鑑定,她的孩子身上有記號,孩子的肚臍眼旁邊有一顆痣。 肚臍眼旁邊有一顆痣? 是呀,你的肚臍眼旁邊有痣嗎? 有啊!我的肚臍眼旁邊就是有一顆痣呀,是胎裏帶來的!可是她怎麼知道? 她怎麼不知道?我爸也知道,他倆都這麼說的。 </s></s> 這麼說那個孩子真是我了?</s>	surprise	surprise
<s> 你們等好消息吧!不過咱們還得再接再厲,多掙錢快掙錢,掙錢還帳! 你媽是那樣說的嗎?說她孩子的身上有一顆痣? 這還有錯嗎?我跟我爸媽說去作親子鑑定。我媽就說不用鑑定,她的孩子身上有記號,孩子的肚臍眼旁邊有一顆痣。 肚臍眼旁邊有一顆痣? 是呀,你的肚臍眼旁邊有痣嗎? 有啊!我的肚臍眼旁邊就是有一顆痣呀,是胎裏帶來的!可是她怎麼知道? 她怎麼不知道?我爸也知道,他倆都這麼說的。 這麼說那個孩子真是我了? </s></s> 你身上有痣嗎,在肚臍眼旁邊?</s>	surprise	surprise
<s> 你們等好消息吧!不過咱們還得再接再厲,多掙錢快掙錢,掙錢還帳! 你媽是那樣說的嗎?說她孩子的身上有一顆痣? 這還有錯嗎?我跟我爸媽說去作親子鑑定。我媽就說不用鑑定,她的孩子身上有記號,孩子的肚臍眼旁邊有一顆痣。 肚臍眼旁邊有一顆痣? 是呀,你的肚臍眼旁邊有痣嗎? 有啊!我的肚臍眼旁邊就是有一顆痣呀,是胎裏帶來的!可是她怎麼知道? 她怎麼不知道?我爸也知道,他倆都這麼說的。 這麼說那個孩子真是我了? 你身上有痣嗎,在肚臍眼旁邊? </s></s> 有啊!你看!</s>	neutral	surprise
<s></s></s> 哎呀!太巧啦!太神奇啦!真的是你呀?剛纔你怎麼不承認呢?</s>	surprise	surprise
<s> 哎呀!太巧啦!太神奇啦!真的是你呀?剛纔你怎麼不承認呢? </s></s> “</s>	neutral	neutral
<s></s></s> “這回好了!啥也不用說了!也不用作什麼鑑定了,快去吧,去</s>	joy	surprise
<s> “這回好了!啥也不用說了!也不用作什麼鑑定了,快去吧,去 </s></s> 現在就去嗎?</s>	neutral	surprise
<s> “這回好了!啥也不用說了!也不用作什麼鑑定了,快去吧,去 現在就去嗎? </s></s> 去唄!</s>	joy	joy
<s> “這回好了!啥也不用說了!也不用作什麼鑑定了,快去吧,去 現在就去嗎? 去唄! </s></s> 明天吧,今天回去準備準備,我還得跟我爸媽他們說一下。</s>	neutral	neutral
<s> “這回好了!啥也不用說了!也不用作什麼鑑定了,快去吧,去 現在就去嗎? 去唄! 明天吧,今天回去準備準備,我還得跟我爸媽他們說一下。 </s></s> 好吧,我先送你回家,然後我和我爸去取錢。</s>	neutral	joy
<s></s></s> 爺爺!</s>	surprise	joy
<s> 爺爺! </s></s> 小軍回來了?</s>	surprise	joy
<s></s></s> 我今天有點事,先回來了。</s>	neutral	neutral
<s> 我今天有點事,先回來了。 </s></s> “小軍回來了,咱們就</s>	neutral	neutral
<s></s></s> 寶林還沒回來?</s>	surprise	surprise
<s> 寶林還沒回來? </s></s> 他來電話了,說中午有飯局,不回來了。</s>	neutral	neutral
<s> 寶林還沒回來? 他來電話了,說中午有飯局,不回來了。 </s></s> 又是飯局,現在咋這麼多飯局?</s>	surprise	surprise
<s></s></s> 媽,咱們說的作親子鑑定那個事,不用作了。</s>	joy	neutral
<s> 媽,咱們說的作親子鑑定那個事,不用作了。 </s></s> 爲啥?</s>	surprise	surprise
<s></s></s> 找到證明了,完全能證明我就是韓東他爸扔的那個孩子。</s>	angry	neutral
<s> 找到證明了,完全能證明我就是韓東他爸扔的那個孩子。 </s></s> 誰能證明?誰看見他扔孩子了?</s>	surprise	surprise
<s></s></s> 沒人看見他扔孩子。證明就在我自己身上。</s>	neutral	neutral
<s> 沒人看見他扔孩子。證明就在我自己身上。 </s></s> 你身上有啥證明?</s>	surprise	surprise
<s></s></s> 韓東他媽說了,他孩子的肚臍眼旁邊有一顆痣。我的肚臍眼旁邊不就是有一顆痣嗎?這還不能證明?</s>	surprise	neutral
<s> 韓東他媽說了,他孩子的肚臍眼旁邊有一顆痣。我的肚臍眼旁邊不就是有一顆痣嗎?這還不能證明? </s></s> 你的肚臍眼旁邊有一顆痣?是呀,是有一顆痣。她怎麼知道?</s>	surprise	surprise
<s></s></s> 她生的我,她還能不知道?韓東他爸也說了,他也看見了,他給我剪的臍帶。</s>	angry	neutral
<s> 她生的我,她還能不知道?韓東他爸也說了,他也看見了,他給我剪的臍帶。 </s></s> 噢,要這麼說,那還真是了。</s>	surprise	surprise
<s></s></s> 那可不!你說,哪有這麼巧的事?在同一個時間,同一個地點,能生出兩個肚臍眼旁邊長痣的孩子嗎?</s>	surprise	surprise
<s> 那可不!你說,哪有這麼巧的事?在同一個時間,同一個地點,能生出兩個肚臍眼旁邊長痣的孩子嗎? </s></s> “其實,咱們也知道這孩子是有主的,早晚得來找,找來了就</s>	joy	sadness
<s></s></s> 認肯定是要認的,現在還有一件大事要辦呢?</s>	surprise	neutral
<s> 認肯定是要認的,現在還有一件大事要辦呢? </s></s> 啥大事?</s>	surprise	surprise
<s></s></s> 美玉她爸給咱們匯來了一大筆錢,讓我去拿呢!</s>	joy	surprise
<s> 美玉她爸給咱們匯來了一大筆錢,讓我去拿呢! </s></s> 美玉她爸?美玉是誰?她爸是誰?</s>	surprise	surprise
<s> 美玉她爸給咱們匯來了一大筆錢,讓我去拿呢! 美玉她爸?美玉是誰?她爸是誰? </s></s> 美玉她爸就是韓長波他大哥,從南朝鮮來探親的,美玉是他的女兒。</s>	neutral	neutral
<s> 美玉她爸給咱們匯來了一大筆錢,讓我去拿呢! 美玉她爸?美玉是誰?她爸是誰? 美玉她爸就是韓長波他大哥,從南朝鮮來探親的,美玉是他的女兒。 </s></s> 就是說給韓長脖留下兩萬塊錢的那個親戚嗎?</s>	neutral	surprise
<s></s></s> 對呀,就是他。</s>	joy	neutral
<s> 對呀,就是他。 </s></s> 他又匯來了一大筆錢?</s>	surprise	surprise
<s></s></s> 是呀,匯來了八萬!</s>	joy	joy
<s> 是呀,匯來了八萬! </s></s> 他匯來這麼多錢幹啥呀?</s>	surprise	surprise
<s></s></s> 給我還帳。他臨走之前聽說我出事了,欠了十四萬公款,就說回去後匯一點錢來,幫我還款。</s>	neutral	joy
<s> 給我還帳。他臨走之前聽說我出事了,欠了十四萬公款,就說回去後匯一點錢來,幫我還款。 </s></s> 他還真有錢呀。</s>	joy	surprise
<s></s></s> 他自己開了一家小工廠,把工廠賣了,賣來的錢。</s>	joy	neutral
<s> 他自己開了一家小工廠,把工廠賣了,賣來的錢。 </s></s> 就爲給你還帳,他把工廠賣了?</s>	surprise	surprise
<s></s></s> 是呀。</s>	neutral	joy
<s> 是呀。 </s></s> “那可真夠意思。</s>	joy	surprise
<s></s></s> 我不是他們家的孩子嗎?</s>	surprise	surprise
<s> 我不是他們家的孩子嗎? </s></s> 他們對這事可一點都不懷疑呀?</s>	surprise	surprise
<s></s></s> 本來也不應該懷疑呀,當時好多人不是都知道嗎?</s>	surprise	neutral
<s> 本來也不應該懷疑呀,當時好多人不是都知道嗎? </s></s> 當時是當時,現在是現在。他當時要是來找,我根本也不會留下你。</s>	neutral	neutral
<s></s></s> 這也是緣分。我天生就該是您的兒子。</s>	joy	joy
<s> 這也是緣分。我天生就該是您的兒子。 </s></s> 那你更得去認那個爸媽了,還得感謝人家呢。</s>	joy	joy
<s></s></s> 我是來取錢的。昨天鎮政府到我們家裏通知我們,說有一筆匯給我們,讓我們來取。</s>	neutral	neutral
<s> 我是來取錢的。昨天鎮政府到我們家裏通知我們,說有一筆匯給我們,讓我們來取。 </s></s> 請問戶主叫什麼名字?</s>	neutral	neutral
<s></s></s> 他是戶主,叫韓長波。</s>	neutral	neutral
<s> 他是戶主,叫韓長波。 </s></s> 戶口本和身份證帶來了嗎?</s>	surprise	neutral
<s></s></s> 帶來了。</s>	joy	neutral
<s> 帶來了。 </s></s> 是這樣的。收款人是韓長波沒錯。可是收款人韓長波沒有銀行的戶頭和帳號,匯款沒有辦法進入個人的帳戶。你們要拿到匯款,只能到銀行去開一個銀行存款的帳戶,讓銀行把匯款存入你的帳戶裏。這裏有一封匯款人發來的電報,你們可以先看一下。</s>	neutral	neutral
<s></s></s> 沒錯,是我大爺發來的。我們直接去銀行就行了嗎?</s>	joy	surprise
<s> 沒錯,是我大爺發來的。我們直接去銀行就行了嗎? </s></s> 行。</s>	joy	neutral
<s></s></s> 這電報不用帶上嗎?</s>	surprise	surprise
<s> 這電報不用帶上嗎? </s></s> 不用,他們那裏也有電報。</s>	neutral	neutral
<s></s></s> 好的,謝謝!</s>	joy	joy
<s> 好的,謝謝! </s></s> 不用謝,再見!</s>	joy	neutral
<s></s></s> 鎮政府通知我,有一筆匯款,讓我們來取。</s>	joy	neutral
<s> 鎮政府通知我,有一筆匯款,讓我們來取。 </s></s> 哪兒匯來的?</s>	surprise	neutral
<s></s></s> 南韓。</s>	neutral	neutral
<s> 南韓。 </s></s> 匯款人是誰?</s>	surprise	neutral
<s></s></s> 韓長林。</s>	neutral	neutral
<s> 韓長林。 </s></s> 匯給誰的?</s>	surprise	neutral
<s></s></s> 韓長波。</s>	neutral	neutral
<s> 韓長波。 </s></s> 有收款人的戶口本和身份證嗎?</s>	surprise	neutral
<s></s></s> 有。</s>	neutral	neutral
<s> 有。 </s></s> 匯來多少錢?</s>	surprise	neutral
<s></s></s> 八萬。</s>	neutral	neutral
<s> 八萬。 </s></s> 要現金還是存摺?要現金得明天來。</s>	joy	neutral
<s></s></s> 給我們開一個存摺吧。</s>	neutral	neutral
<s> 給我們開一個存摺吧。 </s></s> 開誰的名字?</s>	surprise	neutral
<s></s></s> 是八萬嗎?</s>	surprise	surprise
<s> 是八萬嗎? </s></s> 當然是。</s>	joy	joy
<s> 是八萬嗎? 當然是。 </s></s> 我看看!</s>	joy	surprise
<s></s></s> 個、十、百、千、萬,八萬,沒錯!我拿回去給順子看看,讓她高興高興。</s>	joy	joy
<s> 個、十、百、千、萬,八萬,沒錯!我拿回去給順子看看,讓她高興高興。 </s></s> 我送你回家吧?</s>	joy	joy
<s> 個、十、百、千、萬,八萬,沒錯!我拿回去給順子看看,讓她高興高興。 我送你回家吧? </s></s> 不用,我自個兒走回去。</s>	joy	joy
<s></s></s> 你把東西收好,這還有戶口本和身份證,別丟了。我送你回去吧。</s>	neutral	joy
<s> 你把東西收好,這還有戶口本和身份證,別丟了。我送你回去吧。 </s></s> 好吧。</s>	neutral	joy
<s></s></s> 這回真去了,我還不知道說什麼呢?</s>	surprise	fear
<s> 這回真去了,我還不知道說什麼呢? </s></s> 啥也不用說,人來了就說明一切。</s>	joy	joy
<s> 這回真去了,我還不知道說什麼呢? 啥也不用說,人來了就說明一切。 </s></s> 老人家不會以爲你來了就不走了吧?</s>	neutral	fear
<s> 這回真去了,我還不知道說什麼呢? 啥也不用說,人來了就說明一切。 老人家不會以爲你來了就不走了吧? </s></s> 那倒不會。我們家那小草房也擱不下他呀!</s>	neutral	neutral
<s> 這回真去了,我還不知道說什麼呢? 啥也不用說,人來了就說明一切。 老人家不會以爲你來了就不走了吧? 那倒不會。我們家那小草房也擱不下他呀! </s></s> 曉華姐應該陪我一塊去。</s>	neutral	fear
<s> 這回真去了,我還不知道說什麼呢? 啥也不用說,人來了就說明一切。 老人家不會以爲你來了就不走了吧? 那倒不會。我們家那小草房也擱不下他呀! 曉華姐應該陪我一塊去。 </s></s> “</s>	neutral	neutral
<s></s></s> 這回還多虧我大爺回來,才把這件事弄清楚。要不你看,天天見面,自家人不認自家人。</s>	joy	joy
<s> 這回還多虧我大爺回來,才把這件事弄清楚。要不你看,天天見面,自家人不認自家人。 </s></s> 我說馬軍,你的態度咋來了個一百八十度的大轉彎呀?</s>	disgust	surprise
<s> 這回還多虧我大爺回來,才把這件事弄清楚。要不你看,天天見面,自家人不認自家人。 我說馬軍,你的態度咋來了個一百八十度的大轉彎呀? </s></s> 我轉啥彎了?</s>	angry	surprise
<s> 這回還多虧我大爺回來,才把這件事弄清楚。要不你看,天天見面,自家人不認自家人。 我說馬軍,你的態度咋來了個一百八十度的大轉彎呀? 我轉啥彎了? </s></s> 昨天你還不承認你是他們的親兒子呢,今天咋就承認了呢?</s>	angry	surprise
<s> 這回還多虧我大爺回來,才把這件事弄清楚。要不你看,天天見面,自家人不認自家人。 我說馬軍,你的態度咋來了個一百八十度的大轉彎呀? 我轉啥彎了? 昨天你還不承認你是他們的親兒子呢,今天咋就承認了呢? </s></s> 昨天我還沒發現我身上有記號呢。</s>	neutral	neutral
<s> 這回還多虧我大爺回來,才把這件事弄清楚。要不你看,天天見面,自家人不認自家人。 我說馬軍,你的態度咋來了個一百八十度的大轉彎呀? 我轉啥彎了? 昨天你還不承認你是他們的親兒子呢,今天咋就承認了呢? 昨天我還沒發現我身上有記號呢。 </s></s> 今天就發現了?</s>	surprise	surprise
<s> 這回還多虧我大爺回來,才把這件事弄清楚。要不你看,天天見面,自家人不認自家人。 我說馬軍,你的態度咋來了個一百八十度的大轉彎呀? 我轉啥彎了? 昨天你還不承認你是他們的親兒子呢,今天咋就承認了呢? 昨天我還沒發現我身上有記號呢。 今天就發現了? </s></s> 是呀,昨天晚上脫了衣服才發現的。</s>	neutral	joy
<s> 這回還多虧我大爺回來,才把這件事弄清楚。要不你看,天天見面,自家人不認自家人。 我說馬軍,你的態度咋來了個一百八十度的大轉彎呀? 我轉啥彎了? 昨天你還不承認你是他們的親兒子呢,今天咋就承認了呢? 昨天我還沒發現我身上有記號呢。 今天就發現了? 是呀,昨天晚上脫了衣服才發現的。 </s></s> 騙鬼去吧你!韓東,你可得檢查一下,別讓他弄虛作假把你們糊弄了。</s>	angry	disgust
<s> 這回還多虧我大爺回來,才把這件事弄清楚。要不你看,天天見面,自家人不認自家人。 我說馬軍,你的態度咋來了個一百八十度的大轉彎呀? 我轉啥彎了? 昨天你還不承認你是他們的親兒子呢,今天咋就承認了呢? 昨天我還沒發現我身上有記號呢。 今天就發現了? 是呀,昨天晚上脫了衣服才發現的。 騙鬼去吧你!韓東,你可得檢查一下,別讓他弄虛作假把你們糊弄了。 </s></s> 檢查過了,貨真價實!</s>	joy	joy
<s></s></s> 媽,他就是我弟弟,馬軍!</s>	joy	joy
<s> 媽,他就是我弟弟,馬軍! </s></s> 你弟弟,馬軍?</s>	surprise	surprise
<s></s></s> 媽媽!我是您的孩子,我叫馬軍。</s>	joy	joy
<s> 媽媽!我是您的孩子,我叫馬軍。 </s></s> 孩子!我的孩子!</s>	joy	joy
<s> 媽媽!我是您的孩子,我叫馬軍。 孩子!我的孩子! </s></s> 媽媽!</s>	joy	joy
<s></s></s> 孩子!我的孩子!讓我看看,讓我好好看看,我的孩子!</s>	angry	joy
<s> 孩子!我的孩子!讓我看看,讓我好好看看,我的孩子! </s></s> 媽媽!兒子不孝,沒來看您。</s>	sadness	sadness
<s> 孩子!我的孩子!讓我看看,讓我好好看看,我的孩子! 媽媽!兒子不孝,沒來看您。 </s></s> 好孩子,不怪你,是媽媽不好,媽媽對不住你,差點兒把你丟了。</s>	sadness	joy
<s></s></s> 媽媽,我這不回來了嗎。</s>	fear	joy
<s> 媽媽,我這不回來了嗎。 </s></s> 好孩子!真是好孩子。看,這是你爸。</s>	joy	joy
<s></s></s> 爸爸!</s>	surprise	joy
<s> 爸爸! </s></s> 哎!快上炕,坐下,都坐下!</s>	surprise	joy
<s> 爸爸! 哎!快上炕,坐下,都坐下! </s></s> 您坐!您坐!</s>	joy	joy
<s></s></s> 媽媽,爸爸,回去吧,我們走了。</s>	neutral	joy
<s> 媽媽,爸爸,回去吧,我們走了。 </s></s> 回去吧,阿姨、叔叔。</s>	neutral	joy
<s></s></s> 多好的孩子,和東子一樣高了。</s>	joy	joy
<s> 多好的孩子,和東子一樣高了。 </s></s> 媽!</s>	surprise	joy
<s> 多好的孩子,和東子一樣高了。 媽! </s></s> 東子,這是你親弟弟,你要好好待他。</s>	joy	joy
<s> 多好的孩子,和東子一樣高了。 媽! 東子,這是你親弟弟,你要好好待他。 </s></s> 我知道。</s>	joy	joy
<s> 多好的孩子,和東子一樣高了。 媽! 東子,這是你親弟弟,你要好好待他。 我知道。 </s></s> 小軍以後常來玩!</s>	joy	joy
<s> 多好的孩子,和東子一樣高了。 媽! 東子,這是你親弟弟,你要好好待他。 我知道。 小軍以後常來玩! </s></s> 我還會來的。媽,爸,再見!</s>	joy	joy
<s></s></s> 我今天的表現怎麼樣?沒說錯話吧?</s>	sadness	joy
<s> 我今天的表現怎麼樣?沒說錯話吧? </s></s> 表現很好,可以打一百分。我覺得老太太的表現真好,都沒想到。</s>	joy	joy
<s> 我今天的表現怎麼樣?沒說錯話吧? 表現很好,可以打一百分。我覺得老太太的表現真好,都沒想到。 </s></s> 真的,我也沒想到。</s>	joy	surprise
<s> 我今天的表現怎麼樣?沒說錯話吧? 表現很好,可以打一百分。我覺得老太太的表現真好,都沒想到。 真的,我也沒想到。 </s></s> 這叫有覺悟。</s>	joy	joy
<s> 我今天的表現怎麼樣?沒說錯話吧? 表現很好,可以打一百分。我覺得老太太的表現真好,都沒想到。 真的,我也沒想到。 這叫有覺悟。 </s></s> 通情達理,能做到這一點真不容易,那時候咱們還擔心呢。</s>	joy	joy
<s> 我今天的表現怎麼樣?沒說錯話吧? 表現很好,可以打一百分。我覺得老太太的表現真好,都沒想到。 真的,我也沒想到。 這叫有覺悟。 通情達理,能做到這一點真不容易,那時候咱們還擔心呢。 </s></s> 以後就看馬軍的了,看你怎麼對待這兩個家庭,兩家的親人了。</s>	joy	joy
<s> 我今天的表現怎麼樣?沒說錯話吧? 表現很好,可以打一百分。我覺得老太太的表現真好,都沒想到。 真的,我也沒想到。 這叫有覺悟。 通情達理,能做到這一點真不容易,那時候咱們還擔心呢。 以後就看馬軍的了,看你怎麼對待這兩個家庭,兩家的親人了。 </s></s> 這是好事兒,我有兩個家了。</s>	joy	joy
<s></s></s> 這是我大爺匯來的那八萬塊錢,你拿去還欠款吧。</s>	neutral	joy
<s> 這是我大爺匯來的那八萬塊錢,你拿去還欠款吧。 </s></s> 還真給我呀?</s>	surprise	surprise
<s> 這是我大爺匯來的那八萬塊錢,你拿去還欠款吧。 還真給我呀? </s></s> 可不真的唄!還是假的?</s>	surprise	neutral
<s> 這是我大爺匯來的那八萬塊錢,你拿去還欠款吧。 還真給我呀? 可不真的唄!還是假的? </s></s> 那可真得謝謝你大爺了!</s>	joy	joy
<s> 這是我大爺匯來的那八萬塊錢,你拿去還欠款吧。 還真給我呀? 可不真的唄!還是假的? 那可真得謝謝你大爺了! </s></s> 不是我大爺,是咱大爺!</s>	joy	joy
<s> 這是我大爺匯來的那八萬塊錢,你拿去還欠款吧。 還真給我呀? 可不真的唄!還是假的? 那可真得謝謝你大爺了! 不是我大爺,是咱大爺! </s></s> 對,是咱大爺!</s>	joy	joy
<s> 這是我大爺匯來的那八萬塊錢,你拿去還欠款吧。 還真給我呀? 可不真的唄!還是假的? 那可真得謝謝你大爺了! 不是我大爺,是咱大爺! 對,是咱大爺! </s></s> 這叫一家人不說兩家話。</s>	joy	joy
<s> 這是我大爺匯來的那八萬塊錢,你拿去還欠款吧。 還真給我呀? 可不真的唄!還是假的? 那可真得謝謝你大爺了! 不是我大爺,是咱大爺! 對,是咱大爺! 這叫一家人不說兩家話。 </s></s> 咱們一塊給大爺打個電話吧,告訴他錢收到了,欠款還清了,謝謝他,讓他放心。</s>	joy	joy
<s> 這是我大爺匯來的那八萬塊錢,你拿去還欠款吧。 還真給我呀? 可不真的唄!還是假的? 那可真得謝謝你大爺了! 不是我大爺,是咱大爺! 對,是咱大爺! 這叫一家人不說兩家話。 咱們一塊給大爺打個電話吧,告訴他錢收到了,欠款還清了,謝謝他,讓他放心。 </s></s> 行,你先去還錢吧。</s>	joy	joy
<s> 這是我大爺匯來的那八萬塊錢,你拿去還欠款吧。 還真給我呀? 可不真的唄!還是假的? 那可真得謝謝你大爺了! 不是我大爺,是咱大爺! 對,是咱大爺! 這叫一家人不說兩家話。 咱們一塊給大爺打個電話吧,告訴他錢收到了,欠款還清了,謝謝他,讓他放心。 行,你先去還錢吧。 </s></s> 好吧,我們先走了。</s>	joy	joy
<s> 這是我大爺匯來的那八萬塊錢,你拿去還欠款吧。 還真給我呀? 可不真的唄!還是假的? 那可真得謝謝你大爺了! 不是我大爺,是咱大爺! 對,是咱大爺! 這叫一家人不說兩家話。 咱們一塊給大爺打個電話吧,告訴他錢收到了,欠款還清了,謝謝他,讓他放心。 行,你先去還錢吧。 好吧,我們先走了。 </s></s> 東哥再見!</s>	joy	joy
<s> 還真給我呀? 可不真的唄!還是假的? 那可真得謝謝你大爺了! 不是我大爺,是咱大爺! 對,是咱大爺! 這叫一家人不說兩家話。 咱們一塊給大爺打個電話吧,告訴他錢收到了,欠款還清了,謝謝他,讓他放心。 行,你先去還錢吧。 好吧,我們先走了。 東哥再見! </s></s> 再見!</s>	joy	joy
<s></s></s> 小軍,你上順子家去了?</s>	surprise	surprise
<s> 小軍,你上順子家去了? </s></s> 去了。</s>	neutral	neutral
<s> 小軍,你上順子家去了? 去了。 </s></s> 你跟誰去的?</s>	surprise	surprise
<s></s></s> 我和白鴿,還有韓東。</s>	joy	neutral
<s> 我和白鴿,還有韓東。 </s></s> 老太太說什麼了?</s>	surprise	neutral
<s></s></s> 沒說什麼,她就說對不起我,差點把我丟了。</s>	sadness	joy
<s> 沒說什麼,她就說對不起我,差點把我丟了。 </s></s> 她是這麼說的?</s>	surprise	surprise
<s></s></s> 是呀。她說要不是我媽把我抱回來,我就沒了。</s>	fear	joy
<s> 是呀。她說要不是我媽把我抱回來,我就沒了。 </s></s> 老太太境界還挺高嘛!</s>	joy	joy
<s> 是呀。她說要不是我媽把我抱回來,我就沒了。 老太太境界還挺高嘛! </s></s> 她沒說你是她們家的人,要你回她們家去?</s>	angry	surprise
<s></s></s> 沒有!人家還說要謝謝你們呢,把我養大不容易,叫我好好孝敬你們。</s>	joy	joy
<s> 沒有!人家還說要謝謝你們呢,把我養大不容易,叫我好好孝敬你們。 </s></s> 還真是,啊!</s>	joy	joy
<s> 沒有!人家還說要謝謝你們呢,把我養大不容易,叫我好好孝敬你們。 還真是,啊! </s></s> 你怎麼去的?就空着手,也沒帶點東西?</s>	surprise	angry
<s></s></s> 帶了!我和白鴿給她們買了兩大包東西呢。</s>	joy	joy
<s> 帶了!我和白鴿給她們買了兩大包東西呢。 </s></s> 好!應該。你以後還應該常去看她們。</s>	joy	joy
<s> 帶了!我和白鴿給她們買了兩大包東西呢。 好!應該。你以後還應該常去看她們。 </s></s> 她們還在高麗屯住嗎?</s>	surprise	surprise
<s></s></s> 還在高麗屯。</s>	neutral	neutral
<s> 還在高麗屯。 </s></s> 還住在那個房子裏嗎?</s>	surprise	surprise
<s></s></s> 哪個房子呀?反正現在的房子挺破的,都有點歪了,要我可不敢住,怕倒了,屋裏黑古隆冬的。</s>	fear	fear
<s> 哪個房子呀?反正現在的房子挺破的,都有點歪了,要我可不敢住,怕倒了,屋裏黑古隆冬的。 </s></s> 那就還是那個房子,有三十多年了。</s>	neutral	neutral
<s></s></s> 我看她們家也夠可憐的。</s>	sadness	sadness
<s> 我看她們家也夠可憐的。 </s></s> 咱們是不是應該幫幫她們?</s>	fear	fear
<s> 我看她們家也夠可憐的。 咱們是不是應該幫幫她們? </s></s> 幫了,咋沒幫?這回韓長脖生病住院就是咱們給拿的錢,八千多呢,是吧?</s>	sadness	surprise
<s></s></s> 人家也幫咱們呀。韓東他大爺匯來了八萬塊錢,就是要給我還欠款的。</s>	joy	joy
<s> 人家也幫咱們呀。韓東他大爺匯來了八萬塊錢,就是要給我還欠款的。 </s></s> 還真匯錢來了?</s>	surprise	surprise
<s></s></s> 匯來了,韓東都取回來交給我了。</s>	joy	joy
<s> 匯來了,韓東都取回來交給我了。 </s></s> 錢都在你手裏了?</s>	surprise	surprise
<s></s></s> 是呀,這不是嗎?八萬塊!</s>	surprise	surprise
<s> 是呀,這不是嗎?八萬塊! </s></s> 你還真要用這筆錢呀?</s>	surprise	surprise
<s></s></s> 那咋不用?我爸都給人家付醫藥費了!</s>	angry	surprise
<s> 那咋不用?我爸都給人家付醫藥費了! </s></s> 這還真是一家人了,哈!</s>	joy	joy
<s></s></s> 那咋不是?就是沒有我這事,咱們也是一家人哪,我曉華姐不是韓東的未婚妻嗎?咱們兩家不是親家嗎?</s>	surprise	joy
<s> 那咋不是?就是沒有我這事,咱們也是一家人哪,我曉華姐不是韓東的未婚妻嗎?咱們兩家不是親家嗎? </s></s> 對,對對!是一家人,一家人!</s>	joy	joy
<s> 那咋不是?就是沒有我這事,咱們也是一家人哪,我曉華姐不是韓東的未婚妻嗎?咱們兩家不是親家嗎? 對,對對!是一家人,一家人! </s></s> 不行!這筆錢咱們不能用。</s>	fear	angry
<s></s></s> 爲啥?</s>	surprise	surprise
<s> 爲啥? </s></s> 那咋不能用?咱們不都是一家人嗎?</s>	surprise	surprise
<s> 爲啥? 那咋不能用?咱們不都是一家人嗎? </s></s> 從某種意義上說,咱們是一家人,可實際上咱們只是親家,是一直分開在兩個家庭過日子的兩家人。而且他們家的生活一直都很困難,這小軍知道。他們住的什麼?吃的什麼?他們經歷了多少磨難?現在終於有條件改善一下生活了,咱們卻把那一大筆錢拿過來了,這合適嗎?</s>	surprise	fear
<s> 爲啥? 那咋不能用?咱們不都是一家人嗎? 從某種意義上說,咱們是一家人,可實際上咱們只是親家,是一直分開在兩個家庭過日子的兩家人。而且他們家的生活一直都很困難,這小軍知道。他們住的什麼?吃的什麼?他們經歷了多少磨難?現在終於有條件改善一下生活了,咱們卻把那一大筆錢拿過來了,這合適嗎? </s></s> 嗯,這事是得考慮考慮。</s>	neutral	neutral
<s></s></s> 他們啥都沒說,一點意見都沒有。韓東、他爸、他媽都知道這件事,都願意給我,讓我還公款。</s>	joy	fear
<s> 他們啥都沒說,一點意見都沒有。韓東、他爸、他媽都知道這件事,都願意給我,讓我還公款。 </s></s> 他們沒說是沒說,可咱們應該心裏明白。八萬塊錢不是個小數。人家勞累一生積攢起來的辛苦錢,就這麼拿來給你堵窟窿,咱們於心何忍?</s>	sadness	fear
<s> 他們啥都沒說,一點意見都沒有。韓東、他爸、他媽都知道這件事,都願意給我,讓我還公款。 他們沒說是沒說,可咱們應該心裏明白。八萬塊錢不是個小數。人家勞累一生積攢起來的辛苦錢,就這麼拿來給你堵窟窿,咱們於心何忍? </s></s> 你給他們墊付醫藥費,他們不是也沒說啥嗎?</s>	angry	surprise
<s> 他們啥都沒說,一點意見都沒有。韓東、他爸、他媽都知道這件事,都願意給我,讓我還公款。 他們沒說是沒說,可咱們應該心裏明白。八萬塊錢不是個小數。人家勞累一生積攢起來的辛苦錢,就這麼拿來給你堵窟窿,咱們於心何忍? 你給他們墊付醫藥費,他們不是也沒說啥嗎? </s></s> 這不一樣,錢數不一樣,性質也不一樣。</s>	neutral	disgust
<s> 他們啥都沒說,一點意見都沒有。韓東、他爸、他媽都知道這件事,都願意給我,讓我還公款。 他們沒說是沒說,可咱們應該心裏明白。八萬塊錢不是個小數。人家勞累一生積攢起來的辛苦錢,就這麼拿來給你堵窟窿,咱們於心何忍? 你給他們墊付醫藥費,他們不是也沒說啥嗎? 這不一樣,錢數不一樣,性質也不一樣。 </s></s> 那你給他們墊錢行,他們給咱們墊錢就不行?</s>	angry	angry
<s> 他們啥都沒說,一點意見都沒有。韓東、他爸、他媽都知道這件事,都願意給我,讓我還公款。 他們沒說是沒說,可咱們應該心裏明白。八萬塊錢不是個小數。人家勞累一生積攢起來的辛苦錢,就這麼拿來給你堵窟窿,咱們於心何忍? 你給他們墊付醫藥費,他們不是也沒說啥嗎? 這不一樣,錢數不一樣,性質也不一樣。 那你給他們墊錢行,他們給咱們墊錢就不行? </s></s> 可以這麼說。</s>	neutral	neutral
<s></s></s> 這個錢要不用,我那欠款短時間可就還不清了。</s>	neutral	fear
<s> 這個錢要不用,我那欠款短時間可就還不清了。 </s></s> 短時間還不清就慢慢還吧。</s>	neutral	neutral
<s></s></s> 不是說三個月還不清就算犯法嗎?</s>	angry	fear
<s> 不是說三個月還不清就算犯法嗎? </s></s> 說是這麼說,咱們的法律還沒實行到那一步呢。這事我跟唐局長說過。你的問題並沒有進入司法程序,只要咱們積極還款就行了。</s>	neutral	neutral
<s> 不是說三個月還不清就算犯法嗎? 說是這麼說,咱們的法律還沒實行到那一步呢。這事我跟唐局長說過。你的問題並沒有進入司法程序,只要咱們積極還款就行了。 </s></s> 寶林說的有道哩。這錢咱們還是不要吧。</s>	neutral	fear
<s></s></s> 小姨呢?</s>	surprise	surprise
<s> 小姨呢? </s></s> 還沒來,我們沒去叫她。</s>	neutral	neutral
<s></s></s> 咱們今天回去吧,學校的工程都快竣工了。</s>	joy	neutral
<s> 咱們今天回去吧,學校的工程都快竣工了。 </s></s> 回去唄。咱這個公司算是黃攤兒了?</s>	surprise	fear
<s> 咱們今天回去吧,學校的工程都快竣工了。 回去唄。咱這個公司算是黃攤兒了? </s></s> 也不算黃攤兒,那邊的工程一完工咱們再回來嘛。</s>	joy	neutral
<s> 咱們今天回去吧,學校的工程都快竣工了。 回去唄。咱這個公司算是黃攤兒了? 也不算黃攤兒,那邊的工程一完工咱們再回來嘛。 </s></s> 到那時候黃瓜菜都涼了。</s>	joy	fear
<s> 咱們今天回去吧,學校的工程都快竣工了。 回去唄。咱這個公司算是黃攤兒了? 也不算黃攤兒,那邊的工程一完工咱們再回來嘛。 到那時候黃瓜菜都涼了。 </s></s> 不至於吧,有需求就有市場,有市場就有生意可作。你說,什麼時候會斷了木材的需求呢?</s>	surprise	joy
<s> 咱們今天回去吧,學校的工程都快竣工了。 回去唄。咱這個公司算是黃攤兒了? 也不算黃攤兒,那邊的工程一完工咱們再回來嘛。 到那時候黃瓜菜都涼了。 不至於吧,有需求就有市場,有市場就有生意可作。你說,什麼時候會斷了木材的需求呢? </s></s> 需求是不會斷的,可是木材資源會斷的呀,現在的資源不就越來越少了嗎?</s>	fear	fear
<s> 咱們今天回去吧,學校的工程都快竣工了。 回去唄。咱這個公司算是黃攤兒了? 也不算黃攤兒,那邊的工程一完工咱們再回來嘛。 到那時候黃瓜菜都涼了。 不至於吧,有需求就有市場,有市場就有生意可作。你說,什麼時候會斷了木材的需求呢? 需求是不會斷的,可是木材資源會斷的呀,現在的資源不就越來越少了嗎? </s></s> 咱們就別想那麼多了。這邊還有啥沒辦完的事嗎?報表?稅?</s>	surprise	fear
<s> 咱們今天回去吧,學校的工程都快竣工了。 回去唄。咱這個公司算是黃攤兒了? 也不算黃攤兒,那邊的工程一完工咱們再回來嘛。 到那時候黃瓜菜都涼了。 不至於吧,有需求就有市場,有市場就有生意可作。你說,什麼時候會斷了木材的需求呢? 需求是不會斷的,可是木材資源會斷的呀,現在的資源不就越來越少了嗎? 咱們就別想那麼多了。這邊還有啥沒辦完的事嗎?報表?稅? </s></s> 沒了,就有兩筆欠帳沒收回來,過去了再收吧。我說,他們家辦學校,韓東曉華他們咋不出來,叫咱們出面幹啥?</s>	angry	surprise
<s> 咱們今天回去吧,學校的工程都快竣工了。 回去唄。咱這個公司算是黃攤兒了? 也不算黃攤兒,那邊的工程一完工咱們再回來嘛。 到那時候黃瓜菜都涼了。 不至於吧,有需求就有市場,有市場就有生意可作。你說,什麼時候會斷了木材的需求呢? 需求是不會斷的,可是木材資源會斷的呀,現在的資源不就越來越少了嗎? 咱們就別想那麼多了。這邊還有啥沒辦完的事嗎?報表?稅? 沒了,就有兩筆欠帳沒收回來,過去了再收吧。我說,他們家辦學校,韓東曉華他們咋不出來,叫咱們出面幹啥? </s></s> 咋的了?你不願意幹呀?你不願意幹我一個人幹也行,你還在公司這盯着。</s>	angry	neutral
<s> 咱們今天回去吧,學校的工程都快竣工了。 回去唄。咱這個公司算是黃攤兒了? 也不算黃攤兒,那邊的工程一完工咱們再回來嘛。 到那時候黃瓜菜都涼了。 不至於吧,有需求就有市場,有市場就有生意可作。你說,什麼時候會斷了木材的需求呢? 需求是不會斷的,可是木材資源會斷的呀,現在的資源不就越來越少了嗎? 咱們就別想那麼多了。這邊還有啥沒辦完的事嗎?報表?稅? 沒了,就有兩筆欠帳沒收回來,過去了再收吧。我說,他們家辦學校,韓東曉華他們咋不出來,叫咱們出面幹啥? 咋的了?你不願意幹呀?你不願意幹我一個人幹也行,你還在公司這盯着。 </s></s> 也不是不願意幹,就是覺得不大對頭。</s>	sadness	fear
<s> 咱們今天回去吧,學校的工程都快竣工了。 回去唄。咱這個公司算是黃攤兒了? 也不算黃攤兒,那邊的工程一完工咱們再回來嘛。 到那時候黃瓜菜都涼了。 不至於吧,有需求就有市場,有市場就有生意可作。你說,什麼時候會斷了木材的需求呢? 需求是不會斷的,可是木材資源會斷的呀,現在的資源不就越來越少了嗎? 咱們就別想那麼多了。這邊還有啥沒辦完的事嗎?報表?稅? 沒了,就有兩筆欠帳沒收回來,過去了再收吧。我說,他們家辦學校,韓東曉華他們咋不出來,叫咱們出面幹啥? 咋的了?你不願意幹呀?你不願意幹我一個人幹也行,你還在公司這盯着。 也不是不願意幹,就是覺得不大對頭。 </s></s> 沒什麼不對頭。韓東家是誰家?不也是我的家嗎?韓東是我哥,是咱哥,他的家不也是咱的家嗎?看來咱們還沒習慣這一點。</s>	disgust	neutral
<s> 回去唄。咱這個公司算是黃攤兒了? 也不算黃攤兒,那邊的工程一完工咱們再回來嘛。 到那時候黃瓜菜都涼了。 不至於吧,有需求就有市場,有市場就有生意可作。你說,什麼時候會斷了木材的需求呢? 需求是不會斷的,可是木材資源會斷的呀,現在的資源不就越來越少了嗎? 咱們就別想那麼多了。這邊還有啥沒辦完的事嗎?報表?稅? 沒了,就有兩筆欠帳沒收回來,過去了再收吧。我說,他們家辦學校,韓東曉華他們咋不出來,叫咱們出面幹啥? 咋的了?你不願意幹呀?你不願意幹我一個人幹也行,你還在公司這盯着。 也不是不願意幹,就是覺得不大對頭。 沒什麼不對頭。韓東家是誰家?不也是我的家嗎?韓東是我哥,是咱哥,他的家不也是咱的家嗎?看來咱們還沒習慣這一點。 </s></s> 是沒習慣。</s>	neutral	neutral
<s> 也不算黃攤兒,那邊的工程一完工咱們再回來嘛。 到那時候黃瓜菜都涼了。 不至於吧,有需求就有市場,有市場就有生意可作。你說,什麼時候會斷了木材的需求呢? 需求是不會斷的,可是木材資源會斷的呀,現在的資源不就越來越少了嗎? 咱們就別想那麼多了。這邊還有啥沒辦完的事嗎?報表?稅? 沒了,就有兩筆欠帳沒收回來,過去了再收吧。我說,他們家辦學校,韓東曉華他們咋不出來,叫咱們出面幹啥? 咋的了?你不願意幹呀?你不願意幹我一個人幹也行,你還在公司這盯着。 也不是不願意幹,就是覺得不大對頭。 沒什麼不對頭。韓東家是誰家?不也是我的家嗎?韓東是我哥,是咱哥,他的家不也是咱的家嗎?看來咱們還沒習慣這一點。 是沒習慣。 </s></s> 這也是我爸的意思。我覺得這樣做也對。你看,韓東他們剛把飯店開起來,一弄學校飯店就得停,怪可惜的。再說,咱倆在這大山裏搞木材也不是個長事兒,早晚得回鎮上去。我爸爲這學校出了不少力,幫忙就幫到底,我正好也可以在我的親爸親媽跟前表現表現。</s>	joy	joy
<s> 到那時候黃瓜菜都涼了。 不至於吧,有需求就有市場,有市場就有生意可作。你說,什麼時候會斷了木材的需求呢? 需求是不會斷的,可是木材資源會斷的呀,現在的資源不就越來越少了嗎? 咱們就別想那麼多了。這邊還有啥沒辦完的事嗎?報表?稅? 沒了,就有兩筆欠帳沒收回來,過去了再收吧。我說,他們家辦學校,韓東曉華他們咋不出來,叫咱們出面幹啥? 咋的了?你不願意幹呀?你不願意幹我一個人幹也行,你還在公司這盯着。 也不是不願意幹,就是覺得不大對頭。 沒什麼不對頭。韓東家是誰家?不也是我的家嗎?韓東是我哥,是咱哥,他的家不也是咱的家嗎?看來咱們還沒習慣這一點。 是沒習慣。 這也是我爸的意思。我覺得這樣做也對。你看,韓東他們剛把飯店開起來,一弄學校飯店就得停,怪可惜的。再說,咱倆在這大山裏搞木材也不是個長事兒,早晚得回鎮上去。我爸爲這學校出了不少力,幫忙就幫到底,我正好也可以在我的親爸親媽跟前表現表現。 </s></s> 好嘛!你爸想得真周到。</s>	joy	joy
<s> 不至於吧,有需求就有市場,有市場就有生意可作。你說,什麼時候會斷了木材的需求呢? 需求是不會斷的,可是木材資源會斷的呀,現在的資源不就越來越少了嗎? 咱們就別想那麼多了。這邊還有啥沒辦完的事嗎?報表?稅? 沒了,就有兩筆欠帳沒收回來,過去了再收吧。我說,他們家辦學校,韓東曉華他們咋不出來,叫咱們出面幹啥? 咋的了?你不願意幹呀?你不願意幹我一個人幹也行,你還在公司這盯着。 也不是不願意幹,就是覺得不大對頭。 沒什麼不對頭。韓東家是誰家?不也是我的家嗎?韓東是我哥,是咱哥,他的家不也是咱的家嗎?看來咱們還沒習慣這一點。 是沒習慣。 這也是我爸的意思。我覺得這樣做也對。你看,韓東他們剛把飯店開起來,一弄學校飯店就得停,怪可惜的。再說,咱倆在這大山裏搞木材也不是個長事兒,早晚得回鎮上去。我爸爲這學校出了不少力,幫忙就幫到底,我正好也可以在我的親爸親媽跟前表現表現。 好嘛!你爸想得真周到。 </s></s> 那當然!還是老爸英明。想當初我大爺匯錢來的時候,我是一心要用那錢把我的欠款還上,我爸不讓。現在看不用那筆錢是對的。要是真用了,韓東這邊什麼問題也解決不了,別說建學校了,連他們住的房子都沒錢修。就那老破房子,我都不敢進去,生怕它塌了。現在多好,他們住進了新房,還建起了學校,讓老兩口老有所爲,皆大歡喜。</s>	joy	joy
<s> 需求是不會斷的,可是木材資源會斷的呀,現在的資源不就越來越少了嗎? 咱們就別想那麼多了。這邊還有啥沒辦完的事嗎?報表?稅? 沒了,就有兩筆欠帳沒收回來,過去了再收吧。我說,他們家辦學校,韓東曉華他們咋不出來,叫咱們出面幹啥? 咋的了?你不願意幹呀?你不願意幹我一個人幹也行,你還在公司這盯着。 也不是不願意幹,就是覺得不大對頭。 沒什麼不對頭。韓東家是誰家?不也是我的家嗎?韓東是我哥,是咱哥,他的家不也是咱的家嗎?看來咱們還沒習慣這一點。 是沒習慣。 這也是我爸的意思。我覺得這樣做也對。你看,韓東他們剛把飯店開起來,一弄學校飯店就得停,怪可惜的。再說,咱倆在這大山裏搞木材也不是個長事兒,早晚得回鎮上去。我爸爲這學校出了不少力,幫忙就幫到底,我正好也可以在我的親爸親媽跟前表現表現。 好嘛!你爸想得真周到。 那當然!還是老爸英明。想當初我大爺匯錢來的時候,我是一心要用那錢把我的欠款還上,我爸不讓。現在看不用那筆錢是對的。要是真用了,韓東這邊什麼問題也解決不了,別說建學校了,連他們住的房子都沒錢修。就那老破房子,我都不敢進去,生怕它塌了。現在多好,他們住進了新房,還建起了學校,讓老兩口老有所爲,皆大歡喜。 </s></s> 你欠的款還清了嗎?</s>	surprise	fear
<s> 咱們就別想那麼多了。這邊還有啥沒辦完的事嗎?報表?稅? 沒了,就有兩筆欠帳沒收回來,過去了再收吧。我說,他們家辦學校,韓東曉華他們咋不出來,叫咱們出面幹啥? 咋的了?你不願意幹呀?你不願意幹我一個人幹也行,你還在公司這盯着。 也不是不願意幹,就是覺得不大對頭。 沒什麼不對頭。韓東家是誰家?不也是我的家嗎?韓東是我哥,是咱哥,他的家不也是咱的家嗎?看來咱們還沒習慣這一點。 是沒習慣。 這也是我爸的意思。我覺得這樣做也對。你看,韓東他們剛把飯店開起來,一弄學校飯店就得停,怪可惜的。再說,咱倆在這大山裏搞木材也不是個長事兒,早晚得回鎮上去。我爸爲這學校出了不少力,幫忙就幫到底,我正好也可以在我的親爸親媽跟前表現表現。 好嘛!你爸想得真周到。 那當然!還是老爸英明。想當初我大爺匯錢來的時候,我是一心要用那錢把我的欠款還上,我爸不讓。現在看不用那筆錢是對的。要是真用了,韓東這邊什麼問題也解決不了,別說建學校了,連他們住的房子都沒錢修。就那老破房子,我都不敢進去,生怕它塌了。現在多好,他們住進了新房,還建起了學校,讓老兩口老有所爲,皆大歡喜。 你欠的款還清了嗎? </s></s> 還清了!就是時間晚了一點,沒在年底前還完,那根本不是問題。</s>	joy	joy
<s> 沒了,就有兩筆欠帳沒收回來,過去了再收吧。我說,他們家辦學校,韓東曉華他們咋不出來,叫咱們出面幹啥? 咋的了?你不願意幹呀?你不願意幹我一個人幹也行,你還在公司這盯着。 也不是不願意幹,就是覺得不大對頭。 沒什麼不對頭。韓東家是誰家?不也是我的家嗎?韓東是我哥,是咱哥,他的家不也是咱的家嗎?看來咱們還沒習慣這一點。 是沒習慣。 這也是我爸的意思。我覺得這樣做也對。你看,韓東他們剛把飯店開起來,一弄學校飯店就得停,怪可惜的。再說,咱倆在這大山裏搞木材也不是個長事兒,早晚得回鎮上去。我爸爲這學校出了不少力,幫忙就幫到底,我正好也可以在我的親爸親媽跟前表現表現。 好嘛!你爸想得真周到。 那當然!還是老爸英明。想當初我大爺匯錢來的時候,我是一心要用那錢把我的欠款還上,我爸不讓。現在看不用那筆錢是對的。要是真用了,韓東這邊什麼問題也解決不了,別說建學校了,連他們住的房子都沒錢修。就那老破房子,我都不敢進去,生怕它塌了。現在多好,他們住進了新房,還建起了學校,讓老兩口老有所爲,皆大歡喜。 你欠的款還清了嗎? 還清了!就是時間晚了一點,沒在年底前還完,那根本不是問題。 </s></s> 那咱們就全力以赴把學校的事幹好吧!</s>	joy	joy
<s> 咋的了?你不願意幹呀?你不願意幹我一個人幹也行,你還在公司這盯着。 也不是不願意幹,就是覺得不大對頭。 沒什麼不對頭。韓東家是誰家?不也是我的家嗎?韓東是我哥,是咱哥,他的家不也是咱的家嗎?看來咱們還沒習慣這一點。 是沒習慣。 這也是我爸的意思。我覺得這樣做也對。你看,韓東他們剛把飯店開起來,一弄學校飯店就得停,怪可惜的。再說,咱倆在這大山裏搞木材也不是個長事兒,早晚得回鎮上去。我爸爲這學校出了不少力,幫忙就幫到底,我正好也可以在我的親爸親媽跟前表現表現。 好嘛!你爸想得真周到。 那當然!還是老爸英明。想當初我大爺匯錢來的時候,我是一心要用那錢把我的欠款還上,我爸不讓。現在看不用那筆錢是對的。要是真用了,韓東這邊什麼問題也解決不了,別說建學校了,連他們住的房子都沒錢修。就那老破房子,我都不敢進去,生怕它塌了。現在多好,他們住進了新房,還建起了學校,讓老兩口老有所爲,皆大歡喜。 你欠的款還清了嗎? 還清了!就是時間晚了一點,沒在年底前還完,那根本不是問題。 那咱們就全力以赴把學校的事幹好吧! </s></s> 這就對了,全力以赴!走吧。</s>	joy	joy
<s></s></s> 是呀,不過要還是小姨和你兩人幹,那也只能是個早點部了,你們沒有炒菜呀。</s>	neutral	surprise
<s> 是呀,不過要還是小姨和你兩人幹,那也只能是個早點部了,你們沒有炒菜呀。 </s></s> 是唄。東哥你不開出租了?</s>	surprise	surprise
<s></s></s> 不開了,那麼個老破車,老壞,一到節骨眼兒就壞,太耽誤事兒,也掙不來錢。</s>	sadness	disgust
<s> 不開了,那麼個老破車,老壞,一到節骨眼兒就壞,太耽誤事兒,也掙不來錢。 </s></s> 你跟曉華姐回來真是太好了。你們不回來我都要走了。</s>	joy	joy
<s></s></s> 多虧你沒走,你要走了,這個早點部也得黃。</s>	joy	joy
<s> 多虧你沒走,你要走了,這個早點部也得黃。 </s></s> “曉華,</s>	neutral	neutral
<s></s></s> 好吧。你咋去呀,車也沒了?</s>	surprise	surprise
<s> 好吧。你咋去呀,車也沒了? </s></s> 坐公交呀,現在上高麗屯不是有公交車了嗎?</s>	surprise	joy
<s> 好吧。你咋去呀,車也沒了? 坐公交呀,現在上高麗屯不是有公交車了嗎? </s></s> 噢,這倒挺好,等有空我也去看看,我還沒上高麗屯去過呢。</s>	joy	joy
<s></s></s> 學校快開學了,等學校開學咱們去參加開學典禮吧。</s>	joy	joy
<s> 學校快開學了,等學校開學咱們去參加開學典禮吧。 </s></s> 好啊,到時候我一定去。東哥,你也買一輛摩托車得了唄。你看馬軍他們倆,有一輛摩托車,上青河來回多方便。</s>	joy	joy
<s></s></s> 我去找我爸,你先上工地去吧。</s>	neutral	neutral
<s> 我去找我爸,你先上工地去吧。 </s></s> 我不。你去找你爸,我等着你。</s>	neutral	neutral
<s> 我去找我爸,你先上工地去吧。 我不。你去找你爸,我等着你。 </s></s> 工地上沒有急事嗎?</s>	surprise	surprise
<s> 我去找我爸,你先上工地去吧。 我不。你去找你爸,我等着你。 工地上沒有急事嗎? </s></s> 急的就是錢,除了錢還有啥急事?</s>	surprise	disgust
<s> 我去找我爸,你先上工地去吧。 我不。你去找你爸,我等着你。 工地上沒有急事嗎? 急的就是錢,除了錢還有啥急事? </s></s> 好吧。</s>	neutral	neutral
<s></s></s> 怎麼樣了,周師傅?</s>	surprise	surprise
<s> 怎麼樣了,周師傅? </s></s> 完了,馬上就完了。</s>	neutral	neutral
<s></s></s> 噢,炕盤完了,火牆也完了,爐子也砌完了,還真挺快的嘛。</s>	joy	joy
<s> 噢,炕盤完了,火牆也完了,爐子也砌完了,還真挺快的嘛。 </s></s> 是呀,人家催得緊嘛,說是馬上就開學了。</s>	joy	neutral
<s></s></s> 對,下月一號就開學。</s>	joy	neutral
<s> 對,下月一號就開學。 </s></s> 下月一號?沒問題。這兩間屋子咋還不一樣啊?這一間盤炕,那一間光砌爐子,不盤炕。</s>	surprise	surprise
<s></s></s> 這間是住家的,那間是宿舍。住宿舍的人睡不慣火炕。</s>	neutral	neutral
<s> 這間是住家的,那間是宿舍。住宿舍的人睡不慣火炕。 </s></s> 學生宿舍嗎?</s>	surprise	surprise
<s></s></s> 不是,是老師宿舍。學生沒有住校的。</s>	neutral	neutral
<s> 不是,是老師宿舍。學生沒有住校的。 </s></s> 聽說這是朝鮮族學校?</s>	surprise	surprise
<s></s></s> 對呀,這高麗屯不都是朝鮮人嗎?</s>	surprise	surprise
<s> 對呀,這高麗屯不都是朝鮮人嗎? </s></s> 朝鮮人都不睡火炕。</s>	neutral	neutral
<s></s></s> 就這樣吧,周師傅,給弄好點啊!</s>	neutral	joy
<s> 就這樣吧,周師傅,給弄好點啊! </s></s> 放心吧。</s>	joy	joy
<s></s></s> 見着你爸了?</s>	surprise	surprise
<s> 見着你爸了? </s></s> 見着了。</s>	neutral	neutral
<s> 見着你爸了? 見着了。 </s></s> 怎麼樣?有錢嗎?</s>	surprise	fear
<s> 見着你爸了? 見着了。 怎麼樣?有錢嗎? </s></s> 有。其實他早把錢準備好了,等着咱們來拿呢。</s>	joy	neutral
<s> 見着你爸了? 見着了。 怎麼樣?有錢嗎? 有。其實他早把錢準備好了,等着咱們來拿呢。 </s></s> 你看,咱們還在那瞎着急。</s>	fear	disgust
<s> 見着你爸了? 見着了。 怎麼樣?有錢嗎? 有。其實他早把錢準備好了,等着咱們來拿呢。 你看,咱們還在那瞎着急。 </s></s> 他不知道咱們錢已經用完了。我說工程都快完了。他說沒想到工程搞得這麼快。</s>	joy	neutral
<s> 見着你爸了? 見着了。 怎麼樣?有錢嗎? 有。其實他早把錢準備好了,等着咱們來拿呢。 你看,咱們還在那瞎着急。 他不知道咱們錢已經用完了。我說工程都快完了。他說沒想到工程搞得這麼快。 </s></s> 是唄!他給了多少錢?</s>	joy	surprise
<s></s></s> 給,兩萬!</s>	surprise	joy
<s> 給,兩萬! </s></s> 兩萬?太好了,這下徹底解決了!</s>	joy	joy
<s> 給,兩萬! 兩萬?太好了,這下徹底解決了! </s></s> 是呀,徹底解決了。</s>	joy	joy
<s> 給,兩萬! 兩萬?太好了,這下徹底解決了! 是呀,徹底解決了。 </s></s> 我現在就去取錢。還是你騎車帶我去吧?</s>	joy	joy
<s> 給,兩萬! 兩萬?太好了,這下徹底解決了! 是呀,徹底解決了。 我現在就去取錢。還是你騎車帶我去吧? </s></s> 好,走吧。</s>	joy	joy
<s> 給,兩萬! 兩萬?太好了,這下徹底解決了! 是呀,徹底解決了。 我現在就去取錢。還是你騎車帶我去吧? 好,走吧。 </s></s> 你爸真行!銀行貸款都不用了。</s>	joy	joy
<s> 給,兩萬! 兩萬?太好了,這下徹底解決了! 是呀,徹底解決了。 我現在就去取錢。還是你騎車帶我去吧? 好,走吧。 你爸真行!銀行貸款都不用了。 </s></s> 不,貸款還得貸,將來開學以後用錢的地方多着呢。</s>	joy	neutral
<s> 給,兩萬! 兩萬?太好了,這下徹底解決了! 是呀,徹底解決了。 我現在就去取錢。還是你騎車帶我去吧? 好,走吧。 你爸真行!銀行貸款都不用了。 不,貸款還得貸,將來開學以後用錢的地方多着呢。 </s></s> 韓東他大爺不是還給錢呢嗎?你大爺,也是你大爺了。</s>	joy	joy
<s> 給,兩萬! 兩萬?太好了,這下徹底解決了! 是呀,徹底解決了。 我現在就去取錢。還是你騎車帶我去吧? 好,走吧。 你爸真行!銀行貸款都不用了。 不,貸款還得貸,將來開學以後用錢的地方多着呢。 韓東他大爺不是還給錢呢嗎?你大爺,也是你大爺了。 </s></s> 誰知道能不能給?給了更好,還貸款。</s>	joy	joy
<s> 給,兩萬! 兩萬?太好了,這下徹底解決了! 是呀,徹底解決了。 我現在就去取錢。還是你騎車帶我去吧? 好,走吧。 你爸真行!銀行貸款都不用了。 不,貸款還得貸,將來開學以後用錢的地方多着呢。 韓東他大爺不是還給錢呢嗎?你大爺,也是你大爺了。 誰知道能不能給?給了更好,還貸款。 </s></s> 你爸真夠意思,啊!</s>	joy	joy
<s> 給,兩萬! 兩萬?太好了,這下徹底解決了! 是呀,徹底解決了。 我現在就去取錢。還是你騎車帶我去吧? 好,走吧。 你爸真行!銀行貸款都不用了。 不,貸款還得貸,將來開學以後用錢的地方多着呢。 韓東他大爺不是還給錢呢嗎?你大爺,也是你大爺了。 誰知道能不能給?給了更好,還貸款。 你爸真夠意思,啊! </s></s> 那是咱爸!</s>	joy	joy
<s> 兩萬?太好了,這下徹底解決了! 是呀,徹底解決了。 我現在就去取錢。還是你騎車帶我去吧? 好,走吧。 你爸真行!銀行貸款都不用了。 不,貸款還得貸,將來開學以後用錢的地方多着呢。 韓東他大爺不是還給錢呢嗎?你大爺,也是你大爺了。 誰知道能不能給?給了更好,還貸款。 你爸真夠意思,啊! 那是咱爸! </s></s> 你小姨可真不該再記恨人家了。</s>	joy	joy
<s> 是呀,徹底解決了。 我現在就去取錢。還是你騎車帶我去吧? 好,走吧。 你爸真行!銀行貸款都不用了。 不,貸款還得貸,將來開學以後用錢的地方多着呢。 韓東他大爺不是還給錢呢嗎?你大爺,也是你大爺了。 誰知道能不能給?給了更好,還貸款。 你爸真夠意思,啊! 那是咱爸! 你小姨可真不該再記恨人家了。 </s></s> 那是咱小姨!</s>	joy	joy
<s> 我現在就去取錢。還是你騎車帶我去吧? 好,走吧。 你爸真行!銀行貸款都不用了。 不,貸款還得貸,將來開學以後用錢的地方多着呢。 韓東他大爺不是還給錢呢嗎?你大爺,也是你大爺了。 誰知道能不能給?給了更好,還貸款。 你爸真夠意思,啊! 那是咱爸! 你小姨可真不該再記恨人家了。 那是咱小姨! </s></s> 啥咱咱的!誰跟你咱了?</s>	angry	disgust
<s> 好,走吧。 你爸真行!銀行貸款都不用了。 不,貸款還得貸,將來開學以後用錢的地方多着呢。 韓東他大爺不是還給錢呢嗎?你大爺,也是你大爺了。 誰知道能不能給?給了更好,還貸款。 你爸真夠意思,啊! 那是咱爸! 你小姨可真不該再記恨人家了。 那是咱小姨! 啥咱咱的!誰跟你咱了? </s></s> 還不是早晚的事兒?</s>	surprise	joy
<s></s></s> 你們都在這幹啥,咋不去幹活?</s>	angry	surprise
<s> 你們都在這幹啥,咋不去幹活? </s></s> 我們來看看啥時候給發工錢。</s>	neutral	neutral
<s></s></s> 活幹完了工錢自然就會給,還用問?</s>	surprise	disgust
<s> 活幹完了工錢自然就會給,還用問? </s></s> 早幾天就就沒啥活了。</s>	neutral	neutral
<s></s></s> 馬軍和小白沒在嗎?</s>	surprise	surprise
<s> 馬軍和小白沒在嗎? </s></s> 到現在也沒來呀,他們還來不來了?</s>	surprise	angry
<s></s></s> 咋能不來呢?肯定出去辦事去了唄。你們該幹啥幹啥去吧,看見他們我給你們問問。</s>	joy	angry
<s> 咋能不來呢?肯定出去辦事去了唄。你們該幹啥幹啥去吧,看見他們我給你們問問。 </s></s> 你們在這幹啥呢?咋不去幹活?</s>	surprise	surprise
<s> 咋能不來呢?肯定出去辦事去了唄。你們該幹啥幹啥去吧,看見他們我給你們問問。 你們在這幹啥呢?咋不去幹活? </s></s> “我們來領工資,</s>	neutral	neutral
<s></s></s> 我不是說了嗎?工程一結束,工錢一次發齊。</s>	neutral	angry
<s> 我不是說了嗎?工程一結束,工錢一次發齊。 </s></s> 就這麼一點活了,還不說完就完?</s>	angry	angry
<s></s></s> 說完不等於完呀。</s>	joy	disgust
<s> 說完不等於完呀。 </s></s> 你先說說,還有些什麼活?</s>	neutral	neutral
<s> 說完不等於完呀。 你先說說,還有些什麼活? </s></s> 北房外裝修。</s>	neutral	neutral
<s></s></s> 啥時候完?</s>	surprise	surprise
<s> 啥時候完? </s></s> 最多兩天。</s>	neutral	neutral
<s></s></s> 好!今天是二十二號,再給你三天時間,到二十五號你們徹底完工。</s>	joy	neutral
<s> 好!今天是二十二號,再給你三天時間,到二十五號你們徹底完工。 </s></s> 沒問題!</s>	joy	joy
<s></s></s> 別忙,還有清理場地,包括拆除這個板房。你得把教室裏裏外外都弄的利利索索乾乾淨淨,學校才能裝黑板,擺放桌椅板凳,確保下月一號開學上課。</s>	neutral	neutral
<s> 別忙,還有清理場地,包括拆除這個板房。你得把教室裏裏外外都弄的利利索索乾乾淨淨,學校才能裝黑板,擺放桌椅板凳,確保下月一號開學上課。 </s></s> 沒問題!</s>	joy	joy
<s></s></s> 那就好!這個月的月底以前給你們發最後的工資。</s>	joy	joy
<s> 那就好!這個月的月底以前給你們發最後的工資。 </s></s> 妥了!咱們幹活去吧!</s>	joy	joy
<s></s></s> 小秋妹子!生意不錯吧?</s>	joy	joy
<s> 小秋妹子!生意不錯吧? </s></s> 還行吧,剛開張。你幹啥去呀?</s>	joy	joy
<s> 小秋妹子!生意不錯吧? 還行吧,剛開張。你幹啥去呀? </s></s> 去看看熱鬧呀。</s>	joy	joy
<s></s></s> 看啥熱鬧?</s>	joy	surprise
<s> 看啥熱鬧? </s></s> 高麗屯鮮族小學今天開學,縣裏都來人了!</s>	joy	joy
<s></s></s> 高麗屯有學校了?</s>	surprise	surprise
<s> 高麗屯有學校了? </s></s> 是呀。聽說是韓長脖的親戚捐獻的,也叫希望小學。韓長脖的老婆當校長呢。</s>	joy	joy
<s></s></s> 他的親戚那麼有錢哪?</s>	surprise	surprise
<s> 他的親戚那麼有錢哪? </s></s> 可不唄,人家在國外嘛!聽說捐了八萬呢。</s>	joy	joy
<s></s></s> 八萬?八萬就開了個小學校?我要有那八萬,讓你們半個景陽鎮都富起來!</s>	angry	surprise
<s> 八萬?八萬就開了個小學校?我要有那八萬,讓你們半個景陽鎮都富起來! </s></s> 那不假。走吧,看看去!</s>	joy	joy
<s></s></s> 還穿這件衣服嗎?</s>	surprise	surprise
<s> 還穿這件衣服嗎? </s></s> 當然了!別忘了您是朝鮮人,這學校是朝鮮族學校。</s>	joy	joy
<s> 還穿這件衣服嗎? 當然了!別忘了您是朝鮮人,這學校是朝鮮族學校。 </s></s> 這件最好,我最喜歡了,這還是美玉給我買的呢。</s>	joy	joy
<s> 還穿這件衣服嗎? 當然了!別忘了您是朝鮮人,這學校是朝鮮族學校。 這件最好,我最喜歡了,這還是美玉給我買的呢。 </s></s> 所以您就應該穿這一件。叔叔今天也一定要穿民族服纔好。</s>	joy	joy
<s> 還穿這件衣服嗎? 當然了!別忘了您是朝鮮人,這學校是朝鮮族學校。 這件最好,我最喜歡了,這還是美玉給我買的呢。 所以您就應該穿這一件。叔叔今天也一定要穿民族服纔好。 </s></s> 他也有,也是美玉給買的。美玉真是個好孩子,好姑娘。</s>	joy	joy
<s> 還穿這件衣服嗎? 當然了!別忘了您是朝鮮人,這學校是朝鮮族學校。 這件最好,我最喜歡了,這還是美玉給我買的呢。 所以您就應該穿這一件。叔叔今天也一定要穿民族服纔好。 他也有,也是美玉給買的。美玉真是個好孩子,好姑娘。 </s></s> 您想她了?</s>	surprise	joy
<s> 還穿這件衣服嗎? 當然了!別忘了您是朝鮮人,這學校是朝鮮族學校。 這件最好,我最喜歡了,這還是美玉給我買的呢。 所以您就應該穿這一件。叔叔今天也一定要穿民族服纔好。 他也有,也是美玉給買的。美玉真是個好孩子,好姑娘。 您想她了? </s></s> 怎麼不想!也不知道啥時候還能看見她?</s>	joy	sadness
<s> 還穿這件衣服嗎? 當然了!別忘了您是朝鮮人,這學校是朝鮮族學校。 這件最好,我最喜歡了,這還是美玉給我買的呢。 所以您就應該穿這一件。叔叔今天也一定要穿民族服纔好。 他也有,也是美玉給買的。美玉真是個好孩子,好姑娘。 您想她了? 怎麼不想!也不知道啥時候還能看見她? </s></s> 這您不用愁。現在交通這麼發達,坐飛機兩三個小時就到了。</s>	joy	joy
<s> 還穿這件衣服嗎? 當然了!別忘了您是朝鮮人,這學校是朝鮮族學校。 這件最好,我最喜歡了,這還是美玉給我買的呢。 所以您就應該穿這一件。叔叔今天也一定要穿民族服纔好。 他也有,也是美玉給買的。美玉真是個好孩子,好姑娘。 您想她了? 怎麼不想!也不知道啥時候還能看見她? 這您不用愁。現在交通這麼發達,坐飛機兩三個小時就到了。 </s></s> 是嗎?</s>	neutral	surprise
<s></s></s> 你在那晃盪啥呢?還不快點換衣服?</s>	angry	surprise
<s> 你在那晃盪啥呢?還不快點換衣服? </s></s> 我換啥衣服呀,我又不是校長。</s>	disgust	disgust
<s></s></s> 您不是校長也是學校工作人員哪,您也得上主席臺呀。</s>	joy	joy
<s> 您不是校長也是學校工作人員哪,您也得上主席臺呀。 </s></s> 我還上臺?千萬別讓我上臺,我害怕。</s>	fear	surprise
<s></s></s> 你怕啥?又不是鬥爭你。</s>	angry	surprise
<s> 你怕啥?又不是鬥爭你。 </s></s> 那我也害怕,那麼多的人!那個人也得來吧?</s>	fear	fear
<s></s></s> 哪個人呀?</s>	surprise	surprise
<s> 哪個人呀? </s></s> 就是抓咱們的那個人。</s>	neutral	fear
<s></s></s> 再說了,他不還是小軍他爸嗎?他的乾爸。沒有他,小軍還不知道能不能活下來呢。</s>	sadness	sadness
<s> 再說了,他不還是小軍他爸嗎?他的乾爸。沒有他,小軍還不知道能不能活下來呢。 </s></s> 那我看見他也害怕。</s>	fear	fear
<s></s></s> 那是因爲你們見面太少了,還不瞭解他。其實他是個好人,咱們辦這個民族小學他給幫了不少忙呢。</s>	neutral	joy
<s> 那是因爲你們見面太少了,還不瞭解他。其實他是個好人,咱們辦這個民族小學他給幫了不少忙呢。 </s></s> 他還幫忙了?不是他大爺給的錢嗎?</s>	surprise	surprise
<s></s></s> 不光是錢的事兒呀,辦學校得上級批准,不是誰想辦就能辦的。咱這個學校是他一手給報批下來的。再說,大爺給的錢也不夠,蓋房子是他給墊的錢。</s>	disgust	joy
<s> 不光是錢的事兒呀,辦學校得上級批准,不是誰想辦就能辦的。咱這個學校是他一手給報批下來的。再說,大爺給的錢也不夠,蓋房子是他給墊的錢。 </s></s> 他給墊的錢?</s>	surprise	surprise
<s></s></s> 是呀,墊了好幾萬呢。</s>	joy	joy
<s> 是呀,墊了好幾萬呢。 </s></s> 那這錢可怎麼還給他呀?</s>	surprise	fear
<s></s></s> 還什麼呀,不都是一家人了嗎?</s>	surprise	joy
<s> 還什麼呀,不都是一家人了嗎? </s></s> 一家人了?</s>	surprise	surprise
<s></s></s> 咋不是一家人呀?不管別人咋樣,他可從來沒把咱們當外人。他不光給您幫忙,還給我小姨幫忙呢。我小姨開的飯店也是他給拿的錢。</s>	joy	joy
<s> 咋不是一家人呀?不管別人咋樣,他可從來沒把咱們當外人。他不光給您幫忙,還給我小姨幫忙呢。我小姨開的飯店也是他給拿的錢。 </s></s> 是嗎?</s>	surprise	surprise
<s></s></s> 是唄。您說,我小姨一個退休職工,她哪有錢開飯店呀?這事兒都沒跟我小姨說。</s>	disgust	joy
<s> 是唄。您說,我小姨一個退休職工,她哪有錢開飯店呀?這事兒都沒跟我小姨說。 </s></s> 噢,這倒也真有點難爲他了。</s>	sadness	neutral
<s></s></s> 現在只有你們三個教師嗎?</s>	surprise	surprise
<s> 現在只有你們三個教師嗎? </s></s> 第一學期只開了三個班,三個教師也夠了。</s>	joy	neutral
<s></s></s> 這個學校最多能招幾個班?</s>	surprise	surprise
<s> 這個學校最多能招幾個班? </s></s> 招五、六個班是沒問題的。作爲民族小學,生源有限,也就這些學生了。</s>	neutral	neutral
<s></s></s> 將來招生也不要侷限在高麗屯,附近的村屯都可以來上學。</s>	neutral	neutral
<s> 將來招生也不要侷限在高麗屯,附近的村屯都可以來上學。 </s></s> 對。</s>	neutral	neutral
<s></s></s> 你們三個教師都是當地的嗎?</s>	surprise	surprise
<s> 你們三個教師都是當地的嗎? </s></s> 都是。</s>	neutral	neutral
<s></s></s> 你們都住在高麗屯?</s>	surprise	surprise
<s> 你們都住在高麗屯? </s></s> 都在,兩個有家的住家裏,,一個單身住在學校的宿舍。</s>	neutral	neutral
<s></s></s> 不錯,住校的還能給學校看大門。</s>	joy	joy
<s> 不錯,住校的還能給學校看大門。 </s></s> 就是。</s>	neutral	joy
<s></s></s> 我姓範,我不是教師,東哥讓我來給學校幫幫忙。</s>	neutral	neutral
<s> 我姓範,我不是教師,東哥讓我來給學校幫幫忙。 </s></s> 好,應該給幫忙,別看學校小,麻雀雖小五臟俱全,各方面工作一樣都少不了。行政上的事小范給管起來,教學上的事,你們當老師的就擔當起來,也不用設教導主任了,有什麼問題多商量。對於民辦學校,咱們的政策是一視同仁,還要加以鼓勵,特別是民族的民辦學校,更要支持。鎮政府要多關心,有困難及時給解決。</s>	joy	joy
<s> 我姓範,我不是教師,東哥讓我來給學校幫幫忙。 好,應該給幫忙,別看學校小,麻雀雖小五臟俱全,各方面工作一樣都少不了。行政上的事小范給管起來,教學上的事,你們當老師的就擔當起來,也不用設教導主任了,有什麼問題多商量。對於民辦學校,咱們的政策是一視同仁,還要加以鼓勵,特別是民族的民辦學校,更要支持。鎮政府要多關心,有困難及時給解決。 </s></s> 沒問題,請局長放心。</s>	neutral	joy
<s> 我姓範,我不是教師,東哥讓我來給學校幫幫忙。 好,應該給幫忙,別看學校小,麻雀雖小五臟俱全,各方面工作一樣都少不了。行政上的事小范給管起來,教學上的事,你們當老師的就擔當起來,也不用設教導主任了,有什麼問題多商量。對於民辦學校,咱們的政策是一視同仁,還要加以鼓勵,特別是民族的民辦學校,更要支持。鎮政府要多關心,有困難及時給解決。 沒問題,請局長放心。 </s></s> “謝謝</s>	joy	joy
<s></s></s> 大家靜一靜!</s>	neutral	neutral
<s> 大家靜一靜! </s></s> 景陽鎮朝鮮族希望小學開學典禮現在開始!</s>	joy	neutral
<s> 大家靜一靜! 景陽鎮朝鮮族希望小學開學典禮現在開始! </s></s> 大會第一項,升國旗,奏國歌!</s>	joy	neutral
<s> 大家靜一靜! 景陽鎮朝鮮族希望小學開學典禮現在開始! 大會第一項,升國旗,奏國歌! </s></s> “大會第二項,縣教育局</s>	neutral	neutral
<s> 大家靜一靜! 景陽鎮朝鮮族希望小學開學典禮現在開始! 大會第一項,升國旗,奏國歌! “大會第二項,縣教育局 </s></s> 同志們!景陽鎮朝鮮族希望小學今天開學了。我代表縣領導對朝鮮族希望小學的開學表示熱烈地祝賀!</s>	joy	joy
<s></s></s> 景陽鎮朝鮮族希望小學,是景陽鎮第一所希望小學,也是咱們縣第一所朝鮮族的希望小學。這所希望小學是由景陽鎮的韓長林先生出資捐助的。韓長林先生雖然旅居國外,但他關心祖國的經濟建設,關懷家鄉的教育事業,自己出資興建了這所希望小學。另外,咱們景陽鎮的企業家馬寶林同志也給予了資金贊助。讓我們向韓先生和馬寶林同志表示衷心地感謝!</s>	joy	joy
<s> 景陽鎮朝鮮族希望小學,是景陽鎮第一所希望小學,也是咱們縣第一所朝鮮族的希望小學。這所希望小學是由景陽鎮的韓長林先生出資捐助的。韓長林先生雖然旅居國外,但他關心祖國的經濟建設,關懷家鄉的教育事業,自己出資興建了這所希望小學。另外,咱們景陽鎮的企業家馬寶林同志也給予了資金贊助。讓我們向韓先生和馬寶林同志表示衷心地感謝! </s></s> 我希望小學校的教師和同學們,珍惜這個學校,熱愛這個學校,教師教好課,學生學習好,不辜負韓先生和馬寶林同志的期望。大家共同努力,把這所希望小學辦成景陽鎮乃至全縣第一流的好學校!謝謝!</s>	joy	joy
<s> 景陽鎮朝鮮族希望小學,是景陽鎮第一所希望小學,也是咱們縣第一所朝鮮族的希望小學。這所希望小學是由景陽鎮的韓長林先生出資捐助的。韓長林先生雖然旅居國外,但他關心祖國的經濟建設,關懷家鄉的教育事業,自己出資興建了這所希望小學。另外,咱們景陽鎮的企業家馬寶林同志也給予了資金贊助。讓我們向韓先生和馬寶林同志表示衷心地感謝! 我希望小學校的教師和同學們,珍惜這個學校,熱愛這個學校,教師教好課,學生學習好,不辜負韓先生和馬寶林同志的期望。大家共同努力,把這所希望小學辦成景陽鎮乃至全縣第一流的好學校!謝謝! </s></s> 大會第三項,請希望小學校長崔順子講話!</s>	neutral	joy
<s></s></s> 鄉親們,我可不會講話呀!今天我真高興。咱們高麗屯有了自個兒的學校了。孩子們上學再也不用往鎮上跑了。那鎮上有多老遠呀!天天就那麼跑哇,颳風下雨的時候多難哪。好多孩子就因爲受不了那累,體格不好,跑不起,不上學了,書也不唸了,成了文盲。現在可好了,咱高麗屯有學校了。咱們一定把這個學校辦好。我是不識字的。鎮上給咱們派來了老師,漢族老師,朝鮮族老師。他們一定能把學生教好。高麗屯的孩子們,都來上學吧!我的話說完啦!</s>	joy	joy
<s> 鄉親們,我可不會講話呀!今天我真高興。咱們高麗屯有了自個兒的學校了。孩子們上學再也不用往鎮上跑了。那鎮上有多老遠呀!天天就那麼跑哇,颳風下雨的時候多難哪。好多孩子就因爲受不了那累,體格不好,跑不起,不上學了,書也不唸了,成了文盲。現在可好了,咱高麗屯有學校了。咱們一定把這個學校辦好。我是不識字的。鎮上給咱們派來了老師,漢族老師,朝鮮族老師。他們一定能把學生教好。高麗屯的孩子們,都來上學吧!我的話說完啦! </s></s> “現在,請</s>	neutral	neutral
<s></s></s> 韓東,你倆約我們出來不會光爲了吃野餐吧?</s>	neutral	surprise
<s> 韓東,你倆約我們出來不會光爲了吃野餐吧? </s></s> 給你們看一樣東西,和你們商量一件事。</s>	neutral	joy
<s> 韓東,你倆約我們出來不會光爲了吃野餐吧? 給你們看一樣東西,和你們商量一件事。 </s></s> 看什麼東西?商量什麼事呀?</s>	surprise	surprise
<s> 韓東,你倆約我們出來不會光爲了吃野餐吧? 給你們看一樣東西,和你們商量一件事。 看什麼東西?商量什麼事呀? </s></s> 到那你就知道了。</s>	joy	joy
<s> 韓東,你倆約我們出來不會光爲了吃野餐吧? 給你們看一樣東西,和你們商量一件事。 看什麼東西?商量什麼事呀? 到那你就知道了。 </s></s> 到哪兒呀?</s>	surprise	surprise
<s> 韓東,你倆約我們出來不會光爲了吃野餐吧? 給你們看一樣東西,和你們商量一件事。 看什麼東西?商量什麼事呀? 到那你就知道了。 到哪兒呀? </s></s> 到那你就知道了。</s>	joy	joy
<s> 韓東,你倆約我們出來不會光爲了吃野餐吧? 給你們看一樣東西,和你們商量一件事。 看什麼東西?商量什麼事呀? 到那你就知道了。 到哪兒呀? 到那你就知道了。 </s></s> 呵,還挺神祕呢!你們飯店今天不開門了?</s>	surprise	surprise
<s> 韓東,你倆約我們出來不會光爲了吃野餐吧? 給你們看一樣東西,和你們商量一件事。 看什麼東西?商量什麼事呀? 到那你就知道了。 到哪兒呀? 到那你就知道了。 呵,還挺神祕呢!你們飯店今天不開門了? </s></s> 今天休息。你們不是也休息嗎?</s>	joy	surprise
<s> 韓東,你倆約我們出來不會光爲了吃野餐吧? 給你們看一樣東西,和你們商量一件事。 看什麼東西?商量什麼事呀? 到那你就知道了。 到哪兒呀? 到那你就知道了。 呵,還挺神祕呢!你們飯店今天不開門了? 今天休息。你們不是也休息嗎? </s></s> 對,休息,也該休息了。</s>	joy	joy
<s> 韓東,你倆約我們出來不會光爲了吃野餐吧? 給你們看一樣東西,和你們商量一件事。 看什麼東西?商量什麼事呀? 到那你就知道了。 到哪兒呀? 到那你就知道了。 呵,還挺神祕呢!你們飯店今天不開門了? 今天休息。你們不是也休息嗎? 對,休息,也該休息了。 </s></s> 從開了那個公司還真沒休息過呢。</s>	neutral	neutral
<s> 韓東,你倆約我們出來不會光爲了吃野餐吧? 給你們看一樣東西,和你們商量一件事。 看什麼東西?商量什麼事呀? 到那你就知道了。 到哪兒呀? 到那你就知道了。 呵,還挺神祕呢!你們飯店今天不開門了? 今天休息。你們不是也休息嗎? 對,休息,也該休息了。 從開了那個公司還真沒休息過呢。 </s></s> 我從開出租到現在也沒休息過呀。</s>	neutral	neutral
<s> 給你們看一樣東西,和你們商量一件事。 看什麼東西?商量什麼事呀? 到那你就知道了。 到哪兒呀? 到那你就知道了。 呵,還挺神祕呢!你們飯店今天不開門了? 今天休息。你們不是也休息嗎? 對,休息,也該休息了。 從開了那個公司還真沒休息過呢。 我從開出租到現在也沒休息過呀。 </s></s> 所以今天咱們一塊休息,好好歇一天。</s>	joy	joy
<s></s></s> 嗨,走在這兒你們會想起來什麼嗎?</s>	joy	joy
<s> 嗨,走在這兒你們會想起來什麼嗎? </s></s> 會想起什麼?</s>	surprise	surprise
<s> 嗨,走在這兒你們會想起來什麼嗎? 會想起什麼? </s></s> 不會想起走在鄉間的小路上嗎?</s>	surprise	joy
<s> 嗨,走在這兒你們會想起來什麼嗎? 會想起什麼? 不會想起走在鄉間的小路上嗎? </s></s> 對呀,走在鄉間的小路上!</s>	joy	surprise
<s></s></s> 就在這裏吧!</s>	neutral	joy
<s> 就在這裏吧! </s></s> 這裏真美!你怎麼會找到這裏來的?</s>	joy	joy
<s> 就在這裏吧! 這裏真美!你怎麼會找到這裏來的? </s></s> 太好了!</s>	joy	joy
<s> 就在這裏吧! 這裏真美!你怎麼會找到這裏來的? 太好了! </s></s> 其實在山上像這樣的地方很多。咱們沒來玩過就是了。</s>	joy	joy
<s> 就在這裏吧! 這裏真美!你怎麼會找到這裏來的? 太好了! 其實在山上像這樣的地方很多。咱們沒來玩過就是了。 </s></s> 這里路翎花這麼多!我跟你們說,這路翎花最好了,別看它的花瓣很小,可是特別香,採上一把回去插在瓶子裏,香氣好幾天都不散。我以前每年春天都要採一些回去。現在越來越少,看不見了。</s>	joy	joy
<s> 就在這裏吧! 這裏真美!你怎麼會找到這裏來的? 太好了! 其實在山上像這樣的地方很多。咱們沒來玩過就是了。 這里路翎花這麼多!我跟你們說,這路翎花最好了,別看它的花瓣很小,可是特別香,採上一把回去插在瓶子裏,香氣好幾天都不散。我以前每年春天都要採一些回去。現在越來越少,看不見了。 </s></s> 今天可以帶一把回去,你看這裏這麼多。</s>	joy	joy
<s></s></s> 光有路翎花也不行,百花盛開纔是春嘛。</s>	joy	joy
<s> 光有路翎花也不行,百花盛開纔是春嘛。 </s></s> 對,咱們這裏就是個百花壇嘛。噯,你們說說這裏都有些什麼花吧。</s>	joy	joy
<s> 光有路翎花也不行,百花盛開纔是春嘛。 對,咱們這裏就是個百花壇嘛。噯,你們說說這裏都有些什麼花吧。 </s></s> 現在還不到開花的季節,只有路翎花開了,別的還沒開呢。</s>	neutral	joy
<s> 光有路翎花也不行,百花盛開纔是春嘛。 對,咱們這裏就是個百花壇嘛。噯,你們說說這裏都有些什麼花吧。 現在還不到開花的季節,只有路翎花開了,別的還沒開呢。 </s></s> 這裏有車<unk>菜、婆婆丁、柳蒿芽、貓耳朵菜、高麗果,還有野韭菜。</s>	joy	joy
<s> 光有路翎花也不行,百花盛開纔是春嘛。 對,咱們這裏就是個百花壇嘛。噯,你們說說這裏都有些什麼花吧。 現在還不到開花的季節,只有路翎花開了,別的還沒開呢。 這裏有車<unk>菜、婆婆丁、柳蒿芽、貓耳朵菜、高麗果,還有野韭菜。 </s></s> 怎麼都是菜呀?</s>	surprise	surprise
<s> 光有路翎花也不行,百花盛開纔是春嘛。 對,咱們這裏就是個百花壇嘛。噯,你們說說這裏都有些什麼花吧。 現在還不到開花的季節,只有路翎花開了,別的還沒開呢。 這裏有車<unk>菜、婆婆丁、柳蒿芽、貓耳朵菜、高麗果,還有野韭菜。 怎麼都是菜呀? </s></s> 可不都是菜唄。老百姓一到春天就吃野菜,能吃的就都叫菜。</s>	joy	joy
<s> 光有路翎花也不行,百花盛開纔是春嘛。 對,咱們這裏就是個百花壇嘛。噯,你們說說這裏都有些什麼花吧。 現在還不到開花的季節,只有路翎花開了,別的還沒開呢。 這裏有車<unk>菜、婆婆丁、柳蒿芽、貓耳朵菜、高麗果,還有野韭菜。 怎麼都是菜呀? 可不都是菜唄。老百姓一到春天就吃野菜,能吃的就都叫菜。 </s></s> 婆婆丁,柳蒿芽,老太太吃了滿炕爬,爬到地上摔掉牙。</s>	sadness	joy
<s> 光有路翎花也不行,百花盛開纔是春嘛。 對,咱們這裏就是個百花壇嘛。噯,你們說說這裏都有些什麼花吧。 現在還不到開花的季節,只有路翎花開了,別的還沒開呢。 這裏有車<unk>菜、婆婆丁、柳蒿芽、貓耳朵菜、高麗果,還有野韭菜。 怎麼都是菜呀? 可不都是菜唄。老百姓一到春天就吃野菜,能吃的就都叫菜。 婆婆丁,柳蒿芽,老太太吃了滿炕爬,爬到地上摔掉牙。 </s></s> 車<unk>菜叫車前草,那不是菜。婆婆丁叫莆公英,也不是菜。</s>	neutral	neutral
<s> 光有路翎花也不行,百花盛開纔是春嘛。 對,咱們這裏就是個百花壇嘛。噯,你們說說這裏都有些什麼花吧。 現在還不到開花的季節,只有路翎花開了,別的還沒開呢。 這裏有車<unk>菜、婆婆丁、柳蒿芽、貓耳朵菜、高麗果,還有野韭菜。 怎麼都是菜呀? 可不都是菜唄。老百姓一到春天就吃野菜,能吃的就都叫菜。 婆婆丁,柳蒿芽,老太太吃了滿炕爬,爬到地上摔掉牙。 車<unk>菜叫車前草,那不是菜。婆婆丁叫莆公英,也不是菜。 </s></s> 不是菜的也叫菜。你沒聽說嗎?洗不淨的是灰菜,煮不爛的是生菜,夠不着的是雲菜,把雲彩也叫菜了。</s>	disgust	joy
<s></s></s> 韓東,你要給我們看什麼東西呀?</s>	surprise	surprise
<s> 韓東,你要給我們看什麼東西呀? </s></s> 給你們看一封信。</s>	neutral	neutral
<s></s></s> 誰的信,美玉的?</s>	joy	surprise
<s> 誰的信,美玉的? </s></s> 你看看就知道了。</s>	joy	neutral
<s></s></s> 徐麗來信了?她在哪兒呢?</s>	surprise	surprise
<s> 徐麗來信了?她在哪兒呢? </s></s> 在深圳呢。</s>	neutral	neutral
<s> 徐麗來信了?她在哪兒呢? 在深圳呢。 </s></s> 這個傢伙,把家裏都急死了,她還沒事兒!跟她家裏說了嗎?</s>	surprise	surprise
<s> 徐麗來信了?她在哪兒呢? 在深圳呢。 這個傢伙,把家裏都急死了,她還沒事兒!跟她家裏說了嗎? </s></s> 說了。她們家已經知道了。我們去一說,她媽又哭了一通。</s>	sadness	neutral
<s> 徐麗來信了?她在哪兒呢? 在深圳呢。 這個傢伙,把家裏都急死了,她還沒事兒!跟她家裏說了嗎? 說了。她們家已經知道了。我們去一說,她媽又哭了一通。 </s></s> 她還寫了個離婚協議書,跟韓東的,讓把手續辦了。</s>	neutral	neutral
<s> 徐麗來信了?她在哪兒呢? 在深圳呢。 這個傢伙,把家裏都急死了,她還沒事兒!跟她家裏說了嗎? 說了。她們家已經知道了。我們去一說,她媽又哭了一通。 她還寫了個離婚協議書,跟韓東的,讓把手續辦了。 </s></s> 這孩子還不錯,還算有責任心。她說了些啥?</s>	surprise	surprise
<s> 徐麗來信了?她在哪兒呢? 在深圳呢。 這個傢伙,把家裏都急死了,她還沒事兒!跟她家裏說了嗎? 說了。她們家已經知道了。我們去一說,她媽又哭了一通。 她還寫了個離婚協議書,跟韓東的,讓把手續辦了。 這孩子還不錯,還算有責任心。她說了些啥? </s></s> 她說深圳好,叫咱們也上深圳去。</s>	joy	neutral
<s> 徐麗來信了?她在哪兒呢? 在深圳呢。 這個傢伙,把家裏都急死了,她還沒事兒!跟她家裏說了嗎? 說了。她們家已經知道了。我們去一說,她媽又哭了一通。 她還寫了個離婚協議書,跟韓東的,讓把手續辦了。 這孩子還不錯,還算有責任心。她說了些啥? 她說深圳好,叫咱們也上深圳去。 </s></s> 她沒記咱們的仇呀?</s>	angry	surprise
<s> 徐麗來信了?她在哪兒呢? 在深圳呢。 這個傢伙,把家裏都急死了,她還沒事兒!跟她家裏說了嗎? 說了。她們家已經知道了。我們去一說,她媽又哭了一通。 她還寫了個離婚協議書,跟韓東的,讓把手續辦了。 這孩子還不錯,還算有責任心。她說了些啥? 她說深圳好,叫咱們也上深圳去。 她沒記咱們的仇呀? </s></s> 那事也不怪咱們,也不怪我,她記啥仇呀。</s>	sadness	disgust
<s> 徐麗來信了?她在哪兒呢? 在深圳呢。 這個傢伙,把家裏都急死了,她還沒事兒!跟她家裏說了嗎? 說了。她們家已經知道了。我們去一說,她媽又哭了一通。 她還寫了個離婚協議書,跟韓東的,讓把手續辦了。 這孩子還不錯,還算有責任心。她說了些啥? 她說深圳好,叫咱們也上深圳去。 她沒記咱們的仇呀? 那事也不怪咱們,也不怪我,她記啥仇呀。 </s></s> 我去掀了她的工具箱,讓她難堪了。</s>	sadness	sadness
<s> 徐麗來信了?她在哪兒呢? 在深圳呢。 這個傢伙,把家裏都急死了,她還沒事兒!跟她家裏說了嗎? 說了。她們家已經知道了。我們去一說,她媽又哭了一通。 她還寫了個離婚協議書,跟韓東的,讓把手續辦了。 這孩子還不錯,還算有責任心。她說了些啥? 她說深圳好,叫咱們也上深圳去。 她沒記咱們的仇呀? 那事也不怪咱們,也不怪我,她記啥仇呀。 我去掀了她的工具箱,讓她難堪了。 </s></s> 她咎由自取。</s>	angry	angry
<s> 在深圳呢。 這個傢伙,把家裏都急死了,她還沒事兒!跟她家裏說了嗎? 說了。她們家已經知道了。我們去一說,她媽又哭了一通。 她還寫了個離婚協議書,跟韓東的,讓把手續辦了。 這孩子還不錯,還算有責任心。她說了些啥? 她說深圳好,叫咱們也上深圳去。 她沒記咱們的仇呀? 那事也不怪咱們,也不怪我,她記啥仇呀。 我去掀了她的工具箱,讓她難堪了。 她咎由自取。 </s></s> 徐麗還是挺有心眼兒的。她跟你先把手續辦了,是指望你還能回心轉意呢。你要是真回心轉意那不一切就都簡單了嗎?</s>	joy	neutral
<s> 這個傢伙,把家裏都急死了,她還沒事兒!跟她家裏說了嗎? 說了。她們家已經知道了。我們去一說,她媽又哭了一通。 她還寫了個離婚協議書,跟韓東的,讓把手續辦了。 這孩子還不錯,還算有責任心。她說了些啥? 她說深圳好,叫咱們也上深圳去。 她沒記咱們的仇呀? 那事也不怪咱們,也不怪我,她記啥仇呀。 我去掀了她的工具箱,讓她難堪了。 她咎由自取。 徐麗還是挺有心眼兒的。她跟你先把手續辦了,是指望你還能回心轉意呢。你要是真回心轉意那不一切就都簡單了嗎? </s></s> 可惜我是寧死不回頭了。</s>	sadness	neutral
<s> 說了。她們家已經知道了。我們去一說,她媽又哭了一通。 她還寫了個離婚協議書,跟韓東的,讓把手續辦了。 這孩子還不錯,還算有責任心。她說了些啥? 她說深圳好,叫咱們也上深圳去。 她沒記咱們的仇呀? 那事也不怪咱們,也不怪我,她記啥仇呀。 我去掀了她的工具箱,讓她難堪了。 她咎由自取。 徐麗還是挺有心眼兒的。她跟你先把手續辦了,是指望你還能回心轉意呢。你要是真回心轉意那不一切就都簡單了嗎? 可惜我是寧死不回頭了。 </s></s> 不過你現在回頭還來得及。她給咱們寫這封信也是最後再給你一個機會。</s>	joy	neutral
<s> 她還寫了個離婚協議書,跟韓東的,讓把手續辦了。 這孩子還不錯,還算有責任心。她說了些啥? 她說深圳好,叫咱們也上深圳去。 她沒記咱們的仇呀? 那事也不怪咱們,也不怪我,她記啥仇呀。 我去掀了她的工具箱,讓她難堪了。 她咎由自取。 徐麗還是挺有心眼兒的。她跟你先把手續辦了,是指望你還能回心轉意呢。你要是真回心轉意那不一切就都簡單了嗎? 可惜我是寧死不回頭了。 不過你現在回頭還來得及。她給咱們寫這封信也是最後再給你一個機會。 </s></s> 這恰好證明了她的那個孩子不是我的,如果是我的,還用費這麼大勁兒嗎?</s>	angry	disgust
<s> 這孩子還不錯,還算有責任心。她說了些啥? 她說深圳好,叫咱們也上深圳去。 她沒記咱們的仇呀? 那事也不怪咱們,也不怪我,她記啥仇呀。 我去掀了她的工具箱,讓她難堪了。 她咎由自取。 徐麗還是挺有心眼兒的。她跟你先把手續辦了,是指望你還能回心轉意呢。你要是真回心轉意那不一切就都簡單了嗎? 可惜我是寧死不回頭了。 不過你現在回頭還來得及。她給咱們寫這封信也是最後再給你一個機會。 這恰好證明了她的那個孩子不是我的,如果是我的,還用費這麼大勁兒嗎? </s></s> 其實,孩子是誰的她自個兒心裏早就有數。</s>	neutral	disgust
<s> 她說深圳好,叫咱們也上深圳去。 她沒記咱們的仇呀? 那事也不怪咱們,也不怪我,她記啥仇呀。 我去掀了她的工具箱,讓她難堪了。 她咎由自取。 徐麗還是挺有心眼兒的。她跟你先把手續辦了,是指望你還能回心轉意呢。你要是真回心轉意那不一切就都簡單了嗎? 可惜我是寧死不回頭了。 不過你現在回頭還來得及。她給咱們寫這封信也是最後再給你一個機會。 這恰好證明了她的那個孩子不是我的,如果是我的,還用費這麼大勁兒嗎? 其實,孩子是誰的她自個兒心裏早就有數。 </s></s> 所以呀,我說這個徐麗挺有心眼兒嘛。</s>	joy	neutral
<s> 她沒記咱們的仇呀? 那事也不怪咱們,也不怪我,她記啥仇呀。 我去掀了她的工具箱,讓她難堪了。 她咎由自取。 徐麗還是挺有心眼兒的。她跟你先把手續辦了,是指望你還能回心轉意呢。你要是真回心轉意那不一切就都簡單了嗎? 可惜我是寧死不回頭了。 不過你現在回頭還來得及。她給咱們寫這封信也是最後再給你一個機會。 這恰好證明了她的那個孩子不是我的,如果是我的,還用費這麼大勁兒嗎? 其實,孩子是誰的她自個兒心裏早就有數。 所以呀,我說這個徐麗挺有心眼兒嘛。 </s></s> 不管怎麼樣,我看這孩子還是有責任心的。咱們可以把她當個朋友。</s>	joy	joy
<s> 那事也不怪咱們,也不怪我,她記啥仇呀。 我去掀了她的工具箱,讓她難堪了。 她咎由自取。 徐麗還是挺有心眼兒的。她跟你先把手續辦了,是指望你還能回心轉意呢。你要是真回心轉意那不一切就都簡單了嗎? 可惜我是寧死不回頭了。 不過你現在回頭還來得及。她給咱們寫這封信也是最後再給你一個機會。 這恰好證明了她的那個孩子不是我的,如果是我的,還用費這麼大勁兒嗎? 其實,孩子是誰的她自個兒心裏早就有數。 所以呀,我說這個徐麗挺有心眼兒嘛。 不管怎麼樣,我看這孩子還是有責任心的。咱們可以把她當個朋友。 </s></s> 對,我也是這麼想。人家真心對咱們,咱們也該真心對她。今天出來就是要跟你們商量這件事。我真不想在景陽鎮待下去了,想換個環境生活。這裏就像一潭死水。你看吧,工人一下崗滿街都是人,都是想掙錢的。徐麗說得也對,在窮人堆兒裏你掙誰的錢去?還不如上南方活動活動。樹挪死,人挪活嘛。在這裏這麼待下去真能把人窩囊死。雖然不能說這裏就是窮山惡水潑婦刁民吧,咱們也不至於就人窮志短哪。</s>	joy	neutral
<s></s></s> “哎,信還寫得不錯,我給你們念一段吧</s>	joy	joy
<s> “哎,信還寫得不錯,我給你們念一段吧 </s></s> 是不錯,出去幾個月就有長進了。不過你以爲徐麗出去就是爲了換一下環境?</s>	surprise	neutral
<s> “哎,信還寫得不錯,我給你們念一段吧 是不錯,出去幾個月就有長進了。不過你以爲徐麗出去就是爲了換一下環境? </s></s> 當然她和咱們不一樣。她是在景陽鎮待不下去了。不過你也不能不承認,她的遠走南方也不完全是消極的。以她那樣的情況,沒自報自棄,破罐子破摔,而是遠走高飛,也是有她的道理的。對她來說這完全是一種積極向上的行爲。要是沒點志氣還走不到這一步呢。</s>	neutral	joy
<s> “哎,信還寫得不錯,我給你們念一段吧 是不錯,出去幾個月就有長進了。不過你以爲徐麗出去就是爲了換一下環境? 當然她和咱們不一樣。她是在景陽鎮待不下去了。不過你也不能不承認,她的遠走南方也不完全是消極的。以她那樣的情況,沒自報自棄,破罐子破摔,而是遠走高飛,也是有她的道理的。對她來說這完全是一種積極向上的行爲。要是沒點志氣還走不到這一步呢。 </s></s> 出去闖蕩闖蕩也好。這麼年輕就開飯店開到啥時候算完?除了開飯店就不能再乾點別的?徐麗人家不是還要坐寫字樓呢嗎?</s>	neutral	neutral
<s> “哎,信還寫得不錯,我給你們念一段吧 是不錯,出去幾個月就有長進了。不過你以爲徐麗出去就是爲了換一下環境? 當然她和咱們不一樣。她是在景陽鎮待不下去了。不過你也不能不承認,她的遠走南方也不完全是消極的。以她那樣的情況,沒自報自棄,破罐子破摔,而是遠走高飛,也是有她的道理的。對她來說這完全是一種積極向上的行爲。要是沒點志氣還走不到這一步呢。 出去闖蕩闖蕩也好。這麼年輕就開飯店開到啥時候算完?除了開飯店就不能再乾點別的?徐麗人家不是還要坐寫字樓呢嗎? </s></s> 你們倆拿定主意了嗎?</s>	neutral	surprise
<s> “哎,信還寫得不錯,我給你們念一段吧 是不錯,出去幾個月就有長進了。不過你以爲徐麗出去就是爲了換一下環境? 當然她和咱們不一樣。她是在景陽鎮待不下去了。不過你也不能不承認,她的遠走南方也不完全是消極的。以她那樣的情況,沒自報自棄,破罐子破摔,而是遠走高飛,也是有她的道理的。對她來說這完全是一種積極向上的行爲。要是沒點志氣還走不到這一步呢。 出去闖蕩闖蕩也好。這麼年輕就開飯店開到啥時候算完?除了開飯店就不能再乾點別的?徐麗人家不是還要坐寫字樓呢嗎? 你們倆拿定主意了嗎? </s></s> 看了徐麗的信給了我們一些啓發,才有了這個想法。在這一點上咱們還得感謝徐麗。是她的行動和這封信給了我們啓示,這纔想起來出去看看,活動活動,要不還是一天到晚圍着鍋臺轉,連出來玩一玩的心思都沒有,更別說改變環境了。</s>	neutral	joy
<s> “哎,信還寫得不錯,我給你們念一段吧 是不錯,出去幾個月就有長進了。不過你以爲徐麗出去就是爲了換一下環境? 當然她和咱們不一樣。她是在景陽鎮待不下去了。不過你也不能不承認,她的遠走南方也不完全是消極的。以她那樣的情況,沒自報自棄,破罐子破摔,而是遠走高飛,也是有她的道理的。對她來說這完全是一種積極向上的行爲。要是沒點志氣還走不到這一步呢。 出去闖蕩闖蕩也好。這麼年輕就開飯店開到啥時候算完?除了開飯店就不能再乾點別的?徐麗人家不是還要坐寫字樓呢嗎? 你們倆拿定主意了嗎? 看了徐麗的信給了我們一些啓發,才有了這個想法。在這一點上咱們還得感謝徐麗。是她的行動和這封信給了我們啓示,這纔想起來出去看看,活動活動,要不還是一天到晚圍着鍋臺轉,連出來玩一玩的心思都沒有,更別說改變環境了。 </s></s> 看來你們也要給我們某種啓示了,來,咱們會餐吧!</s>	joy	joy
<s></s></s> 我也想走!</s>	angry	sadness
<s> 我也想走! </s></s> 你怎麼又想走了?</s>	surprise	surprise
<s></s></s> “我可不是想出去掙錢。我就是要離開景陽鎮。在那件事出來之前和之後,我都曾經想要出去,先是想到韓美玉她們那裏去。但後來我覺得到那裏去也不好。</s>	sadness	neutral
<s> “我可不是想出去掙錢。我就是要離開景陽鎮。在那件事出來之前和之後,我都曾經想要出去,先是想到韓美玉她們那裏去。但後來我覺得到那裏去也不好。 </s></s> 有啥不好?</s>	surprise	surprise
<s> “我可不是想出去掙錢。我就是要離開景陽鎮。在那件事出來之前和之後,我都曾經想要出去,先是想到韓美玉她們那裏去。但後來我覺得到那裏去也不好。 有啥不好? </s></s> 你們知道嗎?我現在得一碗水端平。</s>	neutral	neutral
<s> “我可不是想出去掙錢。我就是要離開景陽鎮。在那件事出來之前和之後,我都曾經想要出去,先是想到韓美玉她們那裏去。但後來我覺得到那裏去也不好。 有啥不好? 你們知道嗎?我現在得一碗水端平。 </s></s> 可憐天下父母心呀。所以你決定上深圳去,兩個家都不要了。可是你想過沒有,兩個家都需要你呀?</s>	sadness	sadness
<s> “我可不是想出去掙錢。我就是要離開景陽鎮。在那件事出來之前和之後,我都曾經想要出去,先是想到韓美玉她們那裏去。但後來我覺得到那裏去也不好。 有啥不好? 你們知道嗎?我現在得一碗水端平。 可憐天下父母心呀。所以你決定上深圳去,兩個家都不要了。可是你想過沒有,兩個家都需要你呀? </s></s> 我想過了。他們都需要我,特別是在出現了這種情況之後,都更加需要我,或者說都更不願意失去我。我就得想想怎麼樣才能讓他們都不會失望。唯一的辦法就是我誰的家都不去,這就會使他們雙方都得到滿足。</s>	joy	neutral
<s> “我可不是想出去掙錢。我就是要離開景陽鎮。在那件事出來之前和之後,我都曾經想要出去,先是想到韓美玉她們那裏去。但後來我覺得到那裏去也不好。 有啥不好? 你們知道嗎?我現在得一碗水端平。 可憐天下父母心呀。所以你決定上深圳去,兩個家都不要了。可是你想過沒有,兩個家都需要你呀? 我想過了。他們都需要我,特別是在出現了這種情況之後,都更加需要我,或者說都更不願意失去我。我就得想想怎麼樣才能讓他們都不會失望。唯一的辦法就是我誰的家都不去,這就會使他們雙方都得到滿足。 </s></s> 不是都得到滿足,是都在心理上保持了平衡。這倒也是個辦法。你們倆商量了嗎?</s>	neutral	surprise
<s> “我可不是想出去掙錢。我就是要離開景陽鎮。在那件事出來之前和之後,我都曾經想要出去,先是想到韓美玉她們那裏去。但後來我覺得到那裏去也不好。 有啥不好? 你們知道嗎?我現在得一碗水端平。 可憐天下父母心呀。所以你決定上深圳去,兩個家都不要了。可是你想過沒有,兩個家都需要你呀? 我想過了。他們都需要我,特別是在出現了這種情況之後,都更加需要我,或者說都更不願意失去我。我就得想想怎麼樣才能讓他們都不會失望。唯一的辦法就是我誰的家都不去,這就會使他們雙方都得到滿足。 不是都得到滿足,是都在心理上保持了平衡。這倒也是個辦法。你們倆商量了嗎? </s></s> 我們商量不商量不是主要的,主要得跟家裏商量,你們不也一樣嗎?</s>	neutral	surprise
<s> “我可不是想出去掙錢。我就是要離開景陽鎮。在那件事出來之前和之後,我都曾經想要出去,先是想到韓美玉她們那裏去。但後來我覺得到那裏去也不好。 有啥不好? 你們知道嗎?我現在得一碗水端平。 可憐天下父母心呀。所以你決定上深圳去,兩個家都不要了。可是你想過沒有,兩個家都需要你呀? 我想過了。他們都需要我,特別是在出現了這種情況之後,都更加需要我,或者說都更不願意失去我。我就得想想怎麼樣才能讓他們都不會失望。唯一的辦法就是我誰的家都不去,這就會使他們雙方都得到滿足。 不是都得到滿足,是都在心理上保持了平衡。這倒也是個辦法。你們倆商量了嗎? 我們商量不商量不是主要的,主要得跟家裏商量,你們不也一樣嗎? </s></s> 主要還是得咱們自己先下定決心。大家都是自由職業者,沒有鐵飯碗了,在哪幹還不都是憑本事,憑力氣?如果在南方混得好,家裏也不會反對。</s>	neutral	neutral
<s> “我可不是想出去掙錢。我就是要離開景陽鎮。在那件事出來之前和之後,我都曾經想要出去,先是想到韓美玉她們那裏去。但後來我覺得到那裏去也不好。 有啥不好? 你們知道嗎?我現在得一碗水端平。 可憐天下父母心呀。所以你決定上深圳去,兩個家都不要了。可是你想過沒有,兩個家都需要你呀? 我想過了。他們都需要我,特別是在出現了這種情況之後,都更加需要我,或者說都更不願意失去我。我就得想想怎麼樣才能讓他們都不會失望。唯一的辦法就是我誰的家都不去,這就會使他們雙方都得到滿足。 不是都得到滿足,是都在心理上保持了平衡。這倒也是個辦法。你們倆商量了嗎? 我們商量不商量不是主要的,主要得跟家裏商量,你們不也一樣嗎? 主要還是得咱們自己先下定決心。大家都是自由職業者,沒有鐵飯碗了,在哪幹還不都是憑本事,憑力氣?如果在南方混得好,家裏也不會反對。 </s></s> 韓東說的對。咱們也不是小孩子了,這點事還作不了主?就下決心幹吧!人家徐麗一個人說走就走了,無牽無掛,咱們還不如她?山上那個公司不也就是兩間房子嗎?退了就是。咱們一起走吧!</s>	joy	joy
<s></s></s> 哈!哈哈!徐麗說得對,外面的世界很精彩。好呀,走吧?走啦!走!</s>	joy	joy
<s> 哈!哈哈!徐麗說得對,外面的世界很精彩。好呀,走吧?走啦!走! </s></s> 對,走吧!爲咱們的新選擇乾杯!</s>	joy	joy
<s> 哈!哈哈!徐麗說得對,外面的世界很精彩。好呀,走吧?走啦!走! 對,走吧!爲咱們的新選擇乾杯! </s></s> 爲咱們未來的合作乾杯!</s>	joy	joy
<s></s></s> 好啦,會餐到此結束。咱們走吧,這是人家的新房,別打擾人家了!</s>	joy	joy
<s> 好啦,會餐到此結束。咱們走吧,這是人家的新房,別打擾人家了! </s></s> 你什麼意思?</s>	surprise	surprise
<s> 好啦,會餐到此結束。咱們走吧,這是人家的新房,別打擾人家了! 你什麼意思? </s></s> 我是說咱們也得好好商量一下咱倆的事兒嘛。</s>	neutral	joy
<s> 好啦,會餐到此結束。咱們走吧,這是人家的新房,別打擾人家了! 你什麼意思? 我是說咱們也得好好商量一下咱倆的事兒嘛。 </s></s> 噢,對,找一個他們看不見的地方!</s>	neutral	joy
<s></s></s> 你看什麼?</s>	surprise	surprise
<s> 你看什麼? </s></s> 看你。古人說秀色可餐,意思是不是說看着漂亮的臉可以讓人忘記吃飯?</s>	joy	joy
<s> 你看什麼? 看你。古人說秀色可餐,意思是不是說看着漂亮的臉可以讓人忘記吃飯? </s></s> 那你就看吧,省下一份糧食。</s>	neutral	neutral
<s></s></s> 不光是看,我還要說。</s>	neutral	joy
<s> 不光是看,我還要說。 </s></s> 說什麼?</s>	surprise	surprise
<s> 不光是看,我還要說。 說什麼? </s></s> 說我愛你!我要說一百遍一千遍,我愛你!我愛你!我感覺到能在你面前這樣痛痛快快地說出來也是一種幸福。</s>	joy	joy
<s></s></s> 我咋看不出你愛我?</s>	angry	joy
<s> 我咋看不出你愛我? </s></s> 這話我今天第一次說出來,實際我早就是這樣想的了,就是不敢說出來,說了怕你生氣,也怕你不信。我心裏一直是想你的,每天都想你,幹活的時候想,走在路上想,開車的時候也想。特別是在圍城那間小屋裏,我真希望你上我這裏來,可是又怕影響你。今天,我們終於可以在一塊了。</s>	joy	joy
<s></s></s> 不用說了,我相信你。</s>	joy	joy
<s> 不用說了,我相信你。 </s></s> 馬軍,你真下決心要走了嗎?</s>	surprise	surprise
<s> 不用說了,我相信你。 馬軍,你真下決心要走了嗎? </s></s> 差不多。你看他們倆不是決心挺大嗎?</s>	joy	joy
<s> 不用說了,我相信你。 馬軍,你真下決心要走了嗎? 差不多。你看他們倆不是決心挺大嗎? </s></s> 你真能捨得爸媽他們?</s>	surprise	surprise
<s> 不用說了,我相信你。 馬軍,你真下決心要走了嗎? 差不多。你看他們倆不是決心挺大嗎? 你真能捨得爸媽他們? </s></s> 你還捨不得嗎?</s>	surprise	surprise
<s> 不用說了,我相信你。 馬軍,你真下決心要走了嗎? 差不多。你看他們倆不是決心挺大嗎? 你真能捨得爸媽他們? 你還捨不得嗎? </s></s> 你是獨子。</s>	neutral	fear