Input	Predicted	True
<s></s></s> 這個,放在這存一下,我們上那邊買衣服,很快回來,行嗎?</s>	joy	joy
<s> 這個,放在這存一下,我們上那邊買衣服,很快回來,行嗎? </s></s> 謝謝老闆!</s>	joy	joy
<s> 這個,放在這存一下,我們上那邊買衣服,很快回來,行嗎? 謝謝老闆! </s></s> 走吧,服裝在那邊。</s>	joy	joy
<s></s></s> 這個多少錢?</s>	surprise	surprise
<s> 這個多少錢? </s></s> 在這裏說的都是人民幣。</s>	neutral	neutral
<s> 這個多少錢? 在這裏說的都是人民幣。 </s></s> 不貴吧?</s>	joy	surprise
<s> 這個多少錢? 在這裏說的都是人民幣。 不貴吧? </s></s> 跟咱們內地比起來當然不貴。</s>	joy	joy
<s> 這個多少錢? 在這裏說的都是人民幣。 不貴吧? 跟咱們內地比起來當然不貴。 </s></s> 還能還價嗎?</s>	surprise	surprise
<s> 這個多少錢? 在這裏說的都是人民幣。 不貴吧? 跟咱們內地比起來當然不貴。 還能還價嗎? </s></s> 能,你買得越多越便宜。</s>	joy	joy
<s> 這個多少錢? 在這裏說的都是人民幣。 不貴吧? 跟咱們內地比起來當然不貴。 還能還價嗎? 能,你買得越多越便宜。 </s></s> 好,我買幾樣帶回去,你幫我參謀參謀。</s>	joy	joy
<s> 這個多少錢? 在這裏說的都是人民幣。 不貴吧? 跟咱們內地比起來當然不貴。 還能還價嗎? 能,你買得越多越便宜。 好,我買幾樣帶回去,你幫我參謀參謀。 </s></s> 大衣先別買,一時半會兒出不了手,冬天再買。</s>	neutral	neutral
<s> 這個多少錢? 在這裏說的都是人民幣。 不貴吧? 跟咱們內地比起來當然不貴。 還能還價嗎? 能,你買得越多越便宜。 好,我買幾樣帶回去,你幫我參謀參謀。 大衣先別買,一時半會兒出不了手,冬天再買。 </s></s> 行。</s>	joy	joy
<s></s></s> 行了,就這些吧,總共多少錢?</s>	joy	joy
<s> 行了,就這些吧,總共多少錢? </s></s> 九百五十元吧。</s>	neutral	neutral
<s></s></s> 九百六十元。</s>	neutral	neutral
<s> 九百六十元。 </s></s> 九百六十元。我們是老朋友了。他是服裝店老闆,第一次來,便宜一點,以後買得還多呢。</s>	joy	joy
<s> 九百六十元。 九百六十元。我們是老朋友了。他是服裝店老闆,第一次來,便宜一點,以後買得還多呢。 </s></s> 九百六十元,正好。</s>	joy	joy
<s></s></s> 咱們走吧,揹包裝滿了,錢也用完了。</s>	joy	joy
<s> 咱們走吧,揹包裝滿了,錢也用完了。 </s></s> 走。</s>	neutral	joy
<s></s></s> 劉傑,把你的包也託運得了,還揹着它幹啥?</s>	surprise	surprise
<s> 劉傑,把你的包也託運得了,還揹着它幹啥? </s></s> 不用,不沉。</s>	neutral	neutral
<s> 劉傑,把你的包也託運得了,還揹着它幹啥? 不用,不沉。 </s></s> 啥不沉?還能比空手輕快?</s>	surprise	surprise
<s> 劉傑,把你的包也託運得了,還揹着它幹啥? 不用,不沉。 啥不沉?還能比空手輕快? </s></s> 他願意背就揹着唄。</s>	neutral	joy
<s> 劉傑,把你的包也託運得了,還揹着它幹啥? 不用,不沉。 啥不沉?還能比空手輕快? 他願意背就揹着唄。 </s></s> 不是,我是說,咱們今天路過海林的時候,不想上楊子榮的陵園去看看嗎?</s>	neutral	joy
<s> 劉傑,把你的包也託運得了,還揹着它幹啥? 不用,不沉。 啥不沉?還能比空手輕快? 他願意背就揹着唄。 不是,我是說,咱們今天路過海林的時候,不想上楊子榮的陵園去看看嗎? </s></s> 上陵園?</s>	surprise	surprise
<s> 劉傑,把你的包也託運得了,還揹着它幹啥? 不用,不沉。 啥不沉?還能比空手輕快? 他願意背就揹着唄。 不是,我是說,咱們今天路過海林的時候,不想上楊子榮的陵園去看看嗎? 上陵園? </s></s> 是呀。</s>	joy	joy
<s> 劉傑,把你的包也託運得了,還揹着它幹啥? 不用,不沉。 啥不沉?還能比空手輕快? 他願意背就揹着唄。 不是,我是說,咱們今天路過海林的時候,不想上楊子榮的陵園去看看嗎? 上陵園? 是呀。 </s></s> 你沒去過嗎?</s>	surprise	surprise
<s> 劉傑,把你的包也託運得了,還揹着它幹啥? 不用,不沉。 啥不沉?還能比空手輕快? 他願意背就揹着唄。 不是,我是說,咱們今天路過海林的時候,不想上楊子榮的陵園去看看嗎? 上陵園? 是呀。 你沒去過嗎? </s></s> 沒有唄,今天劉傑來了,劉傑還不想去看看嗎?</s>	neutral	joy
<s> 劉傑,把你的包也託運得了,還揹着它幹啥? 不用,不沉。 啥不沉?還能比空手輕快? 他願意背就揹着唄。 不是,我是說,咱們今天路過海林的時候,不想上楊子榮的陵園去看看嗎? 上陵園? 是呀。 你沒去過嗎? 沒有唄,今天劉傑來了,劉傑還不想去看看嗎? </s></s> 陵園在哪兒?</s>	surprise	surprise
<s> 劉傑,把你的包也託運得了,還揹着它幹啥? 不用,不沉。 啥不沉?還能比空手輕快? 他願意背就揹着唄。 不是,我是說,咱們今天路過海林的時候,不想上楊子榮的陵園去看看嗎? 上陵園? 是呀。 你沒去過嗎? 沒有唄,今天劉傑來了,劉傑還不想去看看嗎? 陵園在哪兒? </s></s> 就在海林火車站,一下車就是,可近了。</s>	joy	joy
<s> 不用,不沉。 啥不沉?還能比空手輕快? 他願意背就揹着唄。 不是,我是說,咱們今天路過海林的時候,不想上楊子榮的陵園去看看嗎? 上陵園? 是呀。 你沒去過嗎? 沒有唄,今天劉傑來了,劉傑還不想去看看嗎? 陵園在哪兒? 就在海林火車站,一下車就是,可近了。 </s></s> 你想去嗎?</s>	neutral	joy
<s> 啥不沉?還能比空手輕快? 他願意背就揹着唄。 不是,我是說,咱們今天路過海林的時候,不想上楊子榮的陵園去看看嗎? 上陵園? 是呀。 你沒去過嗎? 沒有唄,今天劉傑來了,劉傑還不想去看看嗎? 陵園在哪兒? 就在海林火車站,一下車就是,可近了。 你想去嗎? </s></s> 那就去唄,反正是路過。</s>	joy	neutral
<s> 他願意背就揹着唄。 不是,我是說,咱們今天路過海林的時候,不想上楊子榮的陵園去看看嗎? 上陵園? 是呀。 你沒去過嗎? 沒有唄,今天劉傑來了,劉傑還不想去看看嗎? 陵園在哪兒? 就在海林火車站,一下車就是,可近了。 你想去嗎? 那就去唄,反正是路過。 </s></s> 對了!把這大包託運了吧。</s>	joy	joy
<s> 不是,我是說,咱們今天路過海林的時候,不想上楊子榮的陵園去看看嗎? 上陵園? 是呀。 你沒去過嗎? 沒有唄,今天劉傑來了,劉傑還不想去看看嗎? 陵園在哪兒? 就在海林火車站,一下車就是,可近了。 你想去嗎? 那就去唄,反正是路過。 對了!把這大包託運了吧。 </s></s> 好吧。</s>	neutral	neutral
<s></s></s> 進來!</s>	joy	surprise
<s> 進來! </s></s> 姜科長,你找我?</s>	surprise	surprise
<s> 進來! 姜科長,你找我? </s></s> 對,來來來,請坐!</s>	joy	joy
<s> 進來! 姜科長,你找我? 對,來來來,請坐! </s></s> 找我什麼事兒?</s>	surprise	surprise
<s> 進來! 姜科長,你找我? 對,來來來,請坐! 找我什麼事兒? </s></s> 馬軍不是在哈爾濱買了臺機器嗎?套印的,結果不行,他去退貨了。</s>	neutral	neutral
<s> 進來! 姜科長,你找我? 對,來來來,請坐! 找我什麼事兒? 馬軍不是在哈爾濱買了臺機器嗎?套印的,結果不行,他去退貨了。 </s></s> 是,他給退回去了。</s>	neutral	neutral
<s> 進來! 姜科長,你找我? 對,來來來,請坐! 找我什麼事兒? 馬軍不是在哈爾濱買了臺機器嗎?套印的,結果不行,他去退貨了。 是,他給退回去了。 </s></s> 可是咱們的報紙得出呀,這一期的報是國慶專刊,咱們還要彩色套印,等新機器是來不及了。他在哈爾濱跟印刷廠聯繫了一下,這一期的報由哈爾濱印刷廠給咱們代印,咱們把清樣拿過去就行了。我考慮了一下,這個辦法也行。國慶節的報是一定要出的,而且一定要套色的,不這樣也不行了。咱們花點印刷費,也值,總比出不來報要強吧?</s>	fear	fear
<s> 進來! 姜科長,你找我? 對,來來來,請坐! 找我什麼事兒? 馬軍不是在哈爾濱買了臺機器嗎?套印的,結果不行,他去退貨了。 是,他給退回去了。 可是咱們的報紙得出呀,這一期的報是國慶專刊,咱們還要彩色套印,等新機器是來不及了。他在哈爾濱跟印刷廠聯繫了一下,這一期的報由哈爾濱印刷廠給咱們代印,咱們把清樣拿過去就行了。我考慮了一下,這個辦法也行。國慶節的報是一定要出的,而且一定要套色的,不這樣也不行了。咱們花點印刷費,也值,總比出不來報要強吧? </s></s> 對,這個辦法好。</s>	joy	joy
<s> 進來! 姜科長,你找我? 對,來來來,請坐! 找我什麼事兒? 馬軍不是在哈爾濱買了臺機器嗎?套印的,結果不行,他去退貨了。 是,他給退回去了。 可是咱們的報紙得出呀,這一期的報是國慶專刊,咱們還要彩色套印,等新機器是來不及了。他在哈爾濱跟印刷廠聯繫了一下,這一期的報由哈爾濱印刷廠給咱們代印,咱們把清樣拿過去就行了。我考慮了一下,這個辦法也行。國慶節的報是一定要出的,而且一定要套色的,不這樣也不行了。咱們花點印刷費,也值,總比出不來報要強吧? 對,這個辦法好。 </s></s> 我想,他們給代印是可以的。可這是咱們的報,咱們得有人在場才行,萬一有什麼情況,他們又不瞭解,不熟悉,咱們得在現場幫着解決,光打電話不行。</s>	neutral	fear
<s> 進來! 姜科長,你找我? 對,來來來,請坐! 找我什麼事兒? 馬軍不是在哈爾濱買了臺機器嗎?套印的,結果不行,他去退貨了。 是,他給退回去了。 可是咱們的報紙得出呀,這一期的報是國慶專刊,咱們還要彩色套印,等新機器是來不及了。他在哈爾濱跟印刷廠聯繫了一下,這一期的報由哈爾濱印刷廠給咱們代印,咱們把清樣拿過去就行了。我考慮了一下,這個辦法也行。國慶節的報是一定要出的,而且一定要套色的,不這樣也不行了。咱們花點印刷費,也值,總比出不來報要強吧? 對,這個辦法好。 我想,他們給代印是可以的。可這是咱們的報,咱們得有人在場才行,萬一有什麼情況,他們又不瞭解,不熟悉,咱們得在現場幫着解決,光打電話不行。 </s></s> 是。</s>	neutral	neutral
<s> 進來! 姜科長,你找我? 對,來來來,請坐! 找我什麼事兒? 馬軍不是在哈爾濱買了臺機器嗎?套印的,結果不行,他去退貨了。 是,他給退回去了。 可是咱們的報紙得出呀,這一期的報是國慶專刊,咱們還要彩色套印,等新機器是來不及了。他在哈爾濱跟印刷廠聯繫了一下,這一期的報由哈爾濱印刷廠給咱們代印,咱們把清樣拿過去就行了。我考慮了一下,這個辦法也行。國慶節的報是一定要出的,而且一定要套色的,不這樣也不行了。咱們花點印刷費,也值,總比出不來報要強吧? 對,這個辦法好。 我想,他們給代印是可以的。可這是咱們的報,咱們得有人在場才行,萬一有什麼情況,他們又不瞭解,不熟悉,咱們得在現場幫着解決,光打電話不行。 是。 </s></s> 所以,我想讓你辛苦一趟,你帶着清樣過去,跟他們一起把這期的報印出來。</s>	neutral	joy
<s> 姜科長,你找我? 對,來來來,請坐! 找我什麼事兒? 馬軍不是在哈爾濱買了臺機器嗎?套印的,結果不行,他去退貨了。 是,他給退回去了。 可是咱們的報紙得出呀,這一期的報是國慶專刊,咱們還要彩色套印,等新機器是來不及了。他在哈爾濱跟印刷廠聯繫了一下,這一期的報由哈爾濱印刷廠給咱們代印,咱們把清樣拿過去就行了。我考慮了一下,這個辦法也行。國慶節的報是一定要出的,而且一定要套色的,不這樣也不行了。咱們花點印刷費,也值,總比出不來報要強吧? 對,這個辦法好。 我想,他們給代印是可以的。可這是咱們的報,咱們得有人在場才行,萬一有什麼情況,他們又不瞭解,不熟悉,咱們得在現場幫着解決,光打電話不行。 是。 所以,我想讓你辛苦一趟,你帶着清樣過去,跟他們一起把這期的報印出來。 </s></s> 行!正好我也熟悉一下這種套印機。</s>	joy	joy
<s> 對,來來來,請坐! 找我什麼事兒? 馬軍不是在哈爾濱買了臺機器嗎?套印的,結果不行,他去退貨了。 是,他給退回去了。 可是咱們的報紙得出呀,這一期的報是國慶專刊,咱們還要彩色套印,等新機器是來不及了。他在哈爾濱跟印刷廠聯繫了一下,這一期的報由哈爾濱印刷廠給咱們代印,咱們把清樣拿過去就行了。我考慮了一下,這個辦法也行。國慶節的報是一定要出的,而且一定要套色的,不這樣也不行了。咱們花點印刷費,也值,總比出不來報要強吧? 對,這個辦法好。 我想,他們給代印是可以的。可這是咱們的報,咱們得有人在場才行,萬一有什麼情況,他們又不瞭解,不熟悉,咱們得在現場幫着解決,光打電話不行。 是。 所以,我想讓你辛苦一趟,你帶着清樣過去,跟他們一起把這期的報印出來。 行!正好我也熟悉一下這種套印機。 </s></s> 有你和馬軍兩個人在那,出報就沒問題了。</s>	joy	joy
<s> 找我什麼事兒? 馬軍不是在哈爾濱買了臺機器嗎?套印的,結果不行,他去退貨了。 是,他給退回去了。 可是咱們的報紙得出呀,這一期的報是國慶專刊,咱們還要彩色套印,等新機器是來不及了。他在哈爾濱跟印刷廠聯繫了一下,這一期的報由哈爾濱印刷廠給咱們代印,咱們把清樣拿過去就行了。我考慮了一下,這個辦法也行。國慶節的報是一定要出的,而且一定要套色的,不這樣也不行了。咱們花點印刷費,也值,總比出不來報要強吧? 對,這個辦法好。 我想,他們給代印是可以的。可這是咱們的報,咱們得有人在場才行,萬一有什麼情況,他們又不瞭解,不熟悉,咱們得在現場幫着解決,光打電話不行。 是。 所以,我想讓你辛苦一趟,你帶着清樣過去,跟他們一起把這期的報印出來。 行!正好我也熟悉一下這種套印機。 有你和馬軍兩個人在那,出報就沒問題了。 </s></s> 沒問題。</s>	neutral	joy
<s></s></s> 這是特刊的清樣,你交給馬軍,讓他在付印之前再審查一下。</s>	neutral	neutral
<s> 這是特刊的清樣,你交給馬軍,讓他在付印之前再審查一下。 </s></s> 好。</s>	neutral	neutral
<s> 這是特刊的清樣,你交給馬軍,讓他在付印之前再審查一下。 好。 </s></s> 另外,你再帶個車過去,印好了報直接拉回來,這樣咱們就能在過節之前把特刊報送到職工手上了。</s>	joy	neutral
<s> 這是特刊的清樣,你交給馬軍,讓他在付印之前再審查一下。 好。 另外,你再帶個車過去,印好了報直接拉回來,這樣咱們就能在過節之前把特刊報送到職工手上了。 </s></s> 好,這樣挺好。這兩天我們還發愁呢,特刊怎麼出呀。</s>	sadness	joy
<s> 這是特刊的清樣,你交給馬軍,讓他在付印之前再審查一下。 好。 另外,你再帶個車過去,印好了報直接拉回來,這樣咱們就能在過節之前把特刊報送到職工手上了。 好,這樣挺好。這兩天我們還發愁呢,特刊怎麼出呀。 </s></s> 我想讓你馬上就動身,行嗎?</s>	joy	surprise
<s> 這是特刊的清樣,你交給馬軍,讓他在付印之前再審查一下。 好。 另外,你再帶個車過去,印好了報直接拉回來,這樣咱們就能在過節之前把特刊報送到職工手上了。 好,這樣挺好。這兩天我們還發愁呢,特刊怎麼出呀。 我想讓你馬上就動身,行嗎? </s></s> 行!不馬上動身就來不及了。</s>	joy	surprise
<s> 這是特刊的清樣,你交給馬軍,讓他在付印之前再審查一下。 好。 另外,你再帶個車過去,印好了報直接拉回來,這樣咱們就能在過節之前把特刊報送到職工手上了。 好,這樣挺好。這兩天我們還發愁呢,特刊怎麼出呀。 我想讓你馬上就動身,行嗎? 行!不馬上動身就來不及了。 </s></s> 好,你先回去準備一下,我要了車就讓司機開車過去接你。</s>	neutral	neutral
<s> 這是特刊的清樣,你交給馬軍,讓他在付印之前再審查一下。 好。 另外,你再帶個車過去,印好了報直接拉回來,這樣咱們就能在過節之前把特刊報送到職工手上了。 好,這樣挺好。這兩天我們還發愁呢,特刊怎麼出呀。 我想讓你馬上就動身,行嗎? 行!不馬上動身就來不及了。 好,你先回去準備一下,我要了車就讓司機開車過去接你。 </s></s> 行,那我先走了。</s>	joy	joy
<s> 這是特刊的清樣,你交給馬軍,讓他在付印之前再審查一下。 好。 另外,你再帶個車過去,印好了報直接拉回來,這樣咱們就能在過節之前把特刊報送到職工手上了。 好,這樣挺好。這兩天我們還發愁呢,特刊怎麼出呀。 我想讓你馬上就動身,行嗎? 行!不馬上動身就來不及了。 好,你先回去準備一下,我要了車就讓司機開車過去接你。 行,那我先走了。 </s></s> 好吧。</s>	neutral	neutral
<s></s></s> 上這來坐車倒挺方便,都是白天,不早也不晚,就是來了非得住一宿不可,當天回不去,是吧?</s>	surprise	joy
<s> 上這來坐車倒挺方便,都是白天,不早也不晚,就是來了非得住一宿不可,當天回不去,是吧? </s></s> 那肯定。就算有早班車來,坐車得六七個小時,買完東西也到晚上了,根本回不去。那也比你上廣州去方便呀。</s>	joy	joy
<s> 上這來坐車倒挺方便,都是白天,不早也不晚,就是來了非得住一宿不可,當天回不去,是吧? 那肯定。就算有早班車來,坐車得六七個小時,買完東西也到晚上了,根本回不去。那也比你上廣州去方便呀。 </s></s> 那倒是。以後有時間的話在這多住幾天,這裏挺好玩的吧?</s>	joy	joy
<s> 上這來坐車倒挺方便,都是白天,不早也不晚,就是來了非得住一宿不可,當天回不去,是吧? 那肯定。就算有早班車來,坐車得六七個小時,買完東西也到晚上了,根本回不去。那也比你上廣州去方便呀。 那倒是。以後有時間的話在這多住幾天,這裏挺好玩的吧? </s></s> 那當然。</s>	joy	joy
<s> 上這來坐車倒挺方便,都是白天,不早也不晚,就是來了非得住一宿不可,當天回不去,是吧? 那肯定。就算有早班車來,坐車得六七個小時,買完東西也到晚上了,根本回不去。那也比你上廣州去方便呀。 那倒是。以後有時間的話在這多住幾天,這裏挺好玩的吧? 那當然。 </s></s> 你們玩過?</s>	surprise	surprise
<s> 上這來坐車倒挺方便,都是白天,不早也不晚,就是來了非得住一宿不可,當天回不去,是吧? 那肯定。就算有早班車來,坐車得六七個小時,買完東西也到晚上了,根本回不去。那也比你上廣州去方便呀。 那倒是。以後有時間的話在這多住幾天,這裏挺好玩的吧? 那當然。 你們玩過? </s></s> 玩啥呀!每次都着急忙慌的,買完了趕緊往回走。本來這次我就想玩幾天,劉哥也來了,還不幹!</s>	disgust	disgust
<s> 上這來坐車倒挺方便,都是白天,不早也不晚,就是來了非得住一宿不可,當天回不去,是吧? 那肯定。就算有早班車來,坐車得六七個小時,買完東西也到晚上了,根本回不去。那也比你上廣州去方便呀。 那倒是。以後有時間的話在這多住幾天,這裏挺好玩的吧? 那當然。 你們玩過? 玩啥呀!每次都着急忙慌的,買完了趕緊往回走。本來這次我就想玩幾天,劉哥也來了,還不幹! </s></s> 誰不幹,你姐?</s>	angry	surprise
<s> 上這來坐車倒挺方便,都是白天,不早也不晚,就是來了非得住一宿不可,當天回不去,是吧? 那肯定。就算有早班車來,坐車得六七個小時,買完東西也到晚上了,根本回不去。那也比你上廣州去方便呀。 那倒是。以後有時間的話在這多住幾天,這裏挺好玩的吧? 那當然。 你們玩過? 玩啥呀!每次都着急忙慌的,買完了趕緊往回走。本來這次我就想玩幾天,劉哥也來了,還不幹! 誰不幹,你姐? </s></s> 可不唄!</s>	disgust	disgust
<s> 上這來坐車倒挺方便,都是白天,不早也不晚,就是來了非得住一宿不可,當天回不去,是吧? 那肯定。就算有早班車來,坐車得六七個小時,買完東西也到晚上了,根本回不去。那也比你上廣州去方便呀。 那倒是。以後有時間的話在這多住幾天,這裏挺好玩的吧? 那當然。 你們玩過? 玩啥呀!每次都着急忙慌的,買完了趕緊往回走。本來這次我就想玩幾天,劉哥也來了,還不幹! 誰不幹,你姐? 可不唄! </s></s> 誰不知道玩?我還想玩呢!玩完了喝西北風去?</s>	joy	angry
<s> 上這來坐車倒挺方便,都是白天,不早也不晚,就是來了非得住一宿不可,當天回不去,是吧? 那肯定。就算有早班車來,坐車得六七個小時,買完東西也到晚上了,根本回不去。那也比你上廣州去方便呀。 那倒是。以後有時間的話在這多住幾天,這裏挺好玩的吧? 那當然。 你們玩過? 玩啥呀!每次都着急忙慌的,買完了趕緊往回走。本來這次我就想玩幾天,劉哥也來了,還不幹! 誰不幹,你姐? 可不唄! 誰不知道玩?我還想玩呢!玩完了喝西北風去? </s></s> 又不是天天玩,玩一次還不行?</s>	surprise	disgust
<s> 上這來坐車倒挺方便,都是白天,不早也不晚,就是來了非得住一宿不可,當天回不去,是吧? 那肯定。就算有早班車來,坐車得六七個小時,買完東西也到晚上了,根本回不去。那也比你上廣州去方便呀。 那倒是。以後有時間的話在這多住幾天,這裏挺好玩的吧? 那當然。 你們玩過? 玩啥呀!每次都着急忙慌的,買完了趕緊往回走。本來這次我就想玩幾天,劉哥也來了,還不幹! 誰不幹,你姐? 可不唄! 誰不知道玩?我還想玩呢!玩完了喝西北風去? 又不是天天玩,玩一次還不行? </s></s> 行!下次來給你玩個夠!</s>	joy	joy
<s> 那肯定。就算有早班車來,坐車得六七個小時,買完東西也到晚上了,根本回不去。那也比你上廣州去方便呀。 那倒是。以後有時間的話在這多住幾天,這裏挺好玩的吧? 那當然。 你們玩過? 玩啥呀!每次都着急忙慌的,買完了趕緊往回走。本來這次我就想玩幾天,劉哥也來了,還不幹! 誰不幹,你姐? 可不唄! 誰不知道玩?我還想玩呢!玩完了喝西北風去? 又不是天天玩,玩一次還不行? 行!下次來給你玩個夠! </s></s> 說話算話?</s>	surprise	joy
<s> 那倒是。以後有時間的話在這多住幾天,這裏挺好玩的吧? 那當然。 你們玩過? 玩啥呀!每次都着急忙慌的,買完了趕緊往回走。本來這次我就想玩幾天,劉哥也來了,還不幹! 誰不幹,你姐? 可不唄! 誰不知道玩?我還想玩呢!玩完了喝西北風去? 又不是天天玩,玩一次還不行? 行!下次來給你玩個夠! 說話算話? </s></s> 當然。</s>	joy	joy
<s> 那當然。 你們玩過? 玩啥呀!每次都着急忙慌的,買完了趕緊往回走。本來這次我就想玩幾天,劉哥也來了,還不幹! 誰不幹,你姐? 可不唄! 誰不知道玩?我還想玩呢!玩完了喝西北風去? 又不是天天玩,玩一次還不行? 行!下次來給你玩個夠! 說話算話? 當然。 </s></s> 劉哥,你也聽見了吧?下次咱們還一塊來,在這住上幾天。</s>	joy	joy
<s> 你們玩過? 玩啥呀!每次都着急忙慌的,買完了趕緊往回走。本來這次我就想玩幾天,劉哥也來了,還不幹! 誰不幹,你姐? 可不唄! 誰不知道玩?我還想玩呢!玩完了喝西北風去? 又不是天天玩,玩一次還不行? 行!下次來給你玩個夠! 說話算話? 當然。 劉哥,你也聽見了吧?下次咱們還一塊來,在這住上幾天。 </s></s> 行,下次把娟子也帶來。</s>	joy	joy
<s> 玩啥呀!每次都着急忙慌的,買完了趕緊往回走。本來這次我就想玩幾天,劉哥也來了,還不幹! 誰不幹,你姐? 可不唄! 誰不知道玩?我還想玩呢!玩完了喝西北風去? 又不是天天玩,玩一次還不行? 行!下次來給你玩個夠! 說話算話? 當然。 劉哥,你也聽見了吧?下次咱們還一塊來,在這住上幾天。 行,下次把娟子也帶來。 </s></s> 這次咱們先去看看楊子榮的陵園吧,也不用住,當天還能回去。</s>	joy	joy
<s> 誰不幹,你姐? 可不唄! 誰不知道玩?我還想玩呢!玩完了喝西北風去? 又不是天天玩,玩一次還不行? 行!下次來給你玩個夠! 說話算話? 當然。 劉哥,你也聽見了吧?下次咱們還一塊來,在這住上幾天。 行,下次把娟子也帶來。 這次咱們先去看看楊子榮的陵園吧,也不用住,當天還能回去。 </s></s> 好啊。楊子榮的陵園在哪兒?</s>	joy	joy
<s> 可不唄! 誰不知道玩?我還想玩呢!玩完了喝西北風去? 又不是天天玩,玩一次還不行? 行!下次來給你玩個夠! 說話算話? 當然。 劉哥,你也聽見了吧?下次咱們還一塊來,在這住上幾天。 行,下次把娟子也帶來。 這次咱們先去看看楊子榮的陵園吧,也不用住,當天還能回去。 好啊。楊子榮的陵園在哪兒? </s></s> 就在牡丹江跟前,咱們這趟車路過,來的時候忘指給你看了。</s>	joy	joy
<s> 誰不知道玩?我還想玩呢!玩完了喝西北風去? 又不是天天玩,玩一次還不行? 行!下次來給你玩個夠! 說話算話? 當然。 劉哥,你也聽見了吧?下次咱們還一塊來,在這住上幾天。 行,下次把娟子也帶來。 這次咱們先去看看楊子榮的陵園吧,也不用住,當天還能回去。 好啊。楊子榮的陵園在哪兒? 就在牡丹江跟前,咱們這趟車路過,來的時候忘指給你看了。 </s></s> 那咱們就去看看。</s>	joy	joy
<s></s></s> 劉哥你看,那不是嗎?就那個山崗,有好多松樹的,那就是楊子榮的陵園。</s>	joy	joy
<s> 劉哥你看,那不是嗎?就那個山崗,有好多松樹的,那就是楊子榮的陵園。 </s></s> 噢,就這麼近呀?</s>	surprise	surprise
<s> 劉哥你看,那不是嗎?就那個山崗,有好多松樹的,那就是楊子榮的陵園。 噢,就這麼近呀? </s></s> 是呀,要不下去看看多遺憾呀。</s>	sadness	joy
<s> 劉哥你看,那不是嗎?就那個山崗,有好多松樹的,那就是楊子榮的陵園。 噢,就這麼近呀? 是呀,要不下去看看多遺憾呀。 </s></s> 對,下去看看。</s>	joy	joy
<s> 劉哥你看,那不是嗎?就那個山崗,有好多松樹的,那就是楊子榮的陵園。 噢,就這麼近呀? 是呀,要不下去看看多遺憾呀。 對,下去看看。 </s></s> 也不耽誤事兒,今天當天就能回去。</s>	joy	joy
<s></s></s> 你來過嗎?</s>	surprise	surprise
<s> 你來過嗎? </s></s> 沒有,早就想來,沒時間,今天正好陪你,就來了。</s>	joy	joy
<s> 你來過嗎? 沒有,早就想來,沒時間,今天正好陪你,就來了。 </s></s> 亞琳姐也沒來過?</s>	surprise	surprise
<s> 你來過嗎? 沒有,早就想來,沒時間,今天正好陪你,就來了。 亞琳姐也沒來過? </s></s> 天天忙着作生意,從這路過好幾趟也沒捨得下車。</s>	neutral	neutral
<s> 你來過嗎? 沒有,早就想來,沒時間,今天正好陪你,就來了。 亞琳姐也沒來過? 天天忙着作生意,從這路過好幾趟也沒捨得下車。 </s></s> 多虧呀!今天要不是陪你,她還捨不得下來。</s>	joy	joy
<s> 你來過嗎? 沒有,早就想來,沒時間,今天正好陪你,就來了。 亞琳姐也沒來過? 天天忙着作生意,從這路過好幾趟也沒捨得下車。 多虧呀!今天要不是陪你,她還捨不得下來。 </s></s> :“真得感謝你們了。”</s>	joy	joy
<s></s></s> 據說楊子榮的墳早先是在山崗下面的路邊上,是一個很普通的墳包。後來樣板戲《智取威虎山》一出來,楊子榮的名聲也大起來了,他的墳給遷到山崗山來,還立了碑,建了園林。</s>	neutral	neutral
<s> 據說楊子榮的墳早先是在山崗下面的路邊上,是一個很普通的墳包。後來樣板戲《智取威虎山》一出來,楊子榮的名聲也大起來了,他的墳給遷到山崗山來,還立了碑,建了園林。 </s></s> 咱們去照個相吧?</s>	joy	joy
<s> 據說楊子榮的墳早先是在山崗下面的路邊上,是一個很普通的墳包。後來樣板戲《智取威虎山》一出來,楊子榮的名聲也大起來了,他的墳給遷到山崗山來,還立了碑,建了園林。 咱們去照個相吧? </s></s> 好吧,照相的在哪兒呢?</s>	joy	joy
<s> 據說楊子榮的墳早先是在山崗下面的路邊上,是一個很普通的墳包。後來樣板戲《智取威虎山》一出來,楊子榮的名聲也大起來了,他的墳給遷到山崗山來,還立了碑,建了園林。 咱們去照個相吧? 好吧,照相的在哪兒呢? </s></s> 在他們辦公室,我去叫。</s>	neutral	joy
<s></s></s> 在哪兒照相?</s>	surprise	surprise
<s> 在哪兒照相? </s></s> 在紀念碑前邊,走,咱們先過去吧。</s>	joy	joy
<s></s></s> 來,咱們一塊照一個吧!</s>	joy	joy
<s> 來,咱們一塊照一個吧! </s></s> 你們照吧!</s>	joy	joy
<s> 來,咱們一塊照一個吧! 你們照吧! </s></s> 我們照完了。咱們好不容易來一趟,一塊留個紀念唄。你也就不用再開票了。</s>	joy	joy
<s></s></s> 麗麗,你怎麼回來了?</s>	surprise	surprise
<s> 麗麗,你怎麼回來了? </s></s> “這是我的</s>	neutral	neutral
<s></s></s> 你不是上勞服了嗎?</s>	surprise	surprise
<s> 你不是上勞服了嗎? </s></s> 我是去幫忙,關係還沒轉過去呢。</s>	neutral	neutral
<s> 你不是上勞服了嗎? 我是去幫忙,關係還沒轉過去呢。 </s></s> 轉關係還不是早晚的事兒。</s>	neutral	joy
<s> 你不是上勞服了嗎? 我是去幫忙,關係還沒轉過去呢。 轉關係還不是早晚的事兒。 </s></s> 爲啥還不給你轉關係?</s>	surprise	surprise
<s> 你不是上勞服了嗎? 我是去幫忙,關係還沒轉過去呢。 轉關係還不是早晚的事兒。 爲啥還不給你轉關係? </s></s> 是我不讓他們轉。</s>	neutral	disgust
<s> 你不是上勞服了嗎? 我是去幫忙,關係還沒轉過去呢。 轉關係還不是早晚的事兒。 爲啥還不給你轉關係? 是我不讓他們轉。 </s></s> 那爲啥?</s>	surprise	surprise
<s> 你不是上勞服了嗎? 我是去幫忙,關係還沒轉過去呢。 轉關係還不是早晚的事兒。 爲啥還不給你轉關係? 是我不讓他們轉。 那爲啥? </s></s> 說是讓我上金屬加工廠,可是那個加工廠到現在連個影兒還沒有呢,誰知道還能不能成立?</s>	sadness	fear
<s> 你不是上勞服了嗎? 我是去幫忙,關係還沒轉過去呢。 轉關係還不是早晚的事兒。 爲啥還不給你轉關係? 是我不讓他們轉。 那爲啥? 說是讓我上金屬加工廠,可是那個加工廠到現在連個影兒還沒有呢,誰知道還能不能成立? </s></s> 不是經理都上任了嗎?</s>	surprise	surprise
<s> 你不是上勞服了嗎? 我是去幫忙,關係還沒轉過去呢。 轉關係還不是早晚的事兒。 爲啥還不給你轉關係? 是我不讓他們轉。 那爲啥? 說是讓我上金屬加工廠,可是那個加工廠到現在連個影兒還沒有呢,誰知道還能不能成立? 不是經理都上任了嗎? </s></s> 人家是幹部,上不上任都一樣,到哪兒都是幹部,我一個工人能跟他一樣嗎?</s>	sadness	disgust
<s> 你不是上勞服了嗎? 我是去幫忙,關係還沒轉過去呢。 轉關係還不是早晚的事兒。 爲啥還不給你轉關係? 是我不讓他們轉。 那爲啥? 說是讓我上金屬加工廠,可是那個加工廠到現在連個影兒還沒有呢,誰知道還能不能成立? 不是經理都上任了嗎? 人家是幹部,上不上任都一樣,到哪兒都是幹部,我一個工人能跟他一樣嗎? </s></s> 也對,還是在車間守着吧,不管咋的這還是個鐵飯碗呢。</s>	joy	joy
<s> 你不是上勞服了嗎? 我是去幫忙,關係還沒轉過去呢。 轉關係還不是早晚的事兒。 爲啥還不給你轉關係? 是我不讓他們轉。 那爲啥? 說是讓我上金屬加工廠,可是那個加工廠到現在連個影兒還沒有呢,誰知道還能不能成立? 不是經理都上任了嗎? 人家是幹部,上不上任都一樣,到哪兒都是幹部,我一個工人能跟他一樣嗎? 也對,還是在車間守着吧,不管咋的這還是個鐵飯碗呢。 </s></s> 所以呀,那集體企業也不是誰想去就能去的,你們還是老實兒待着吧,沒看咱麗麗都回來了嗎?</s>	neutral	neutral
<s></s></s> 這裏有個叫徐麗的小姐嗎?是哪一位呀?我們想請教一下這位公主。</s>	neutral	disgust
<s> 這裏有個叫徐麗的小姐嗎?是哪一位呀?我們想請教一下這位公主。 </s></s> 看來你就是徐麗了?果然名不虛傳呀,小臉蛋兒長得挺漂亮嘛!</s>	joy	disgust
<s> 這裏有個叫徐麗的小姐嗎?是哪一位呀?我們想請教一下這位公主。 看來你就是徐麗了?果然名不虛傳呀,小臉蛋兒長得挺漂亮嘛! </s></s> 我說這位漂亮公主又在打誰的主意呢?又看上哪個幹部了,啊?</s>	joy	disgust
<s> 這裏有個叫徐麗的小姐嗎?是哪一位呀?我們想請教一下這位公主。 看來你就是徐麗了?果然名不虛傳呀,小臉蛋兒長得挺漂亮嘛! 我說這位漂亮公主又在打誰的主意呢?又看上哪個幹部了,啊? </s></s> 白鴿,你想幹啥?</s>	joy	disgust
<s> 這裏有個叫徐麗的小姐嗎?是哪一位呀?我們想請教一下這位公主。 看來你就是徐麗了?果然名不虛傳呀,小臉蛋兒長得挺漂亮嘛! 我說這位漂亮公主又在打誰的主意呢?又看上哪個幹部了,啊? 白鴿,你想幹啥? </s></s> 不幹啥,就是想問問,你最近幹啥缺德事兒了?</s>	disgust	disgust
<s></s></s> 我問你,你懷着這邊一個的孩子咋又給那邊的一個寫情書呢?你這叫幹啥?說好聽一點這叫腳踩兩隻船,說得不好聽呢這叫玩弄男性,屬於流氓行爲,對不對?</s>	angry	disgust
<s> 我問你,你懷着這邊一個的孩子咋又給那邊的一個寫情書呢?你這叫幹啥?說好聽一點這叫腳踩兩隻船,說得不好聽呢這叫玩弄男性,屬於流氓行爲,對不對? </s></s> 你胡說!你出去!</s>	angry	angry
<s> 我問你,你懷着這邊一個的孩子咋又給那邊的一個寫情書呢?你這叫幹啥?說好聽一點這叫腳踩兩隻船,說得不好聽呢這叫玩弄男性,屬於流氓行爲,對不對? 你胡說!你出去! </s></s> 我胡說?這不都是你自個兒說的嗎?你當着我朋友的面說你懷了他的孩子,你忘啦?可你又給另外一個男人寫情書,不對嗎?要我把那個人的名字說出來嗎?要我把你寫的情書拿出來念念嗎?</s>	angry	disgust
<s> 我問你,你懷着這邊一個的孩子咋又給那邊的一個寫情書呢?你這叫幹啥?說好聽一點這叫腳踩兩隻船,說得不好聽呢這叫玩弄男性,屬於流氓行爲,對不對? 你胡說!你出去! 我胡說?這不都是你自個兒說的嗎?你當着我朋友的面說你懷了他的孩子,你忘啦?可你又給另外一個男人寫情書,不對嗎?要我把那個人的名字說出來嗎?要我把你寫的情書拿出來念念嗎? </s></s> 你造謠!你血口噴人!你滾出去!</s>	angry	angry
<s> 我問你,你懷着這邊一個的孩子咋又給那邊的一個寫情書呢?你這叫幹啥?說好聽一點這叫腳踩兩隻船,說得不好聽呢這叫玩弄男性,屬於流氓行爲,對不對? 你胡說!你出去! 我胡說?這不都是你自個兒說的嗎?你當着我朋友的面說你懷了他的孩子,你忘啦?可你又給另外一個男人寫情書,不對嗎?要我把那個人的名字說出來嗎?要我把你寫的情書拿出來念念嗎? 你造謠!你血口噴人!你滾出去! </s></s> 不用你攆我也要走的,在你這還怕弄髒了我的鞋呢。我告訴你,小狐狸精,放規矩點,不管你懷着誰的孩子,懷了誰的孩子找誰去。可不許你胡說八道,不許你再去找他,那是我的朋友,知道嗎?你還是個捧鐵飯碗的呢,丟人!</s>	angry	angry
<s></s></s> 今天算給你一個警告,別恬臉不知恥,不知天高地厚。你要是不聽警告再去胡攪蠻纏,就不是今天的待遇了,懂嗎?拜拜!</s>	angry	disgust
<s> 今天算給你一個警告,別恬臉不知恥,不知天高地厚。你要是不聽警告再去胡攪蠻纏,就不是今天的待遇了,懂嗎?拜拜! </s></s> 你混蛋!</s>	angry	angry
<s></s></s> 用車嗎?</s>	surprise	surprise
<s> 用車嗎? </s></s> 狗剩子!你也在這兒?</s>	surprise	surprise
<s> 用車嗎? 狗剩子!你也在這兒? </s></s> 是呀,亞玲姐,你回來了?</s>	surprise	joy
<s> 用車嗎? 狗剩子!你也在這兒? 是呀,亞玲姐,你回來了? </s></s> 啊!還有我姐,劉哥,我們三個人呢。</s>	joy	joy
<s> 用車嗎? 狗剩子!你也在這兒? 是呀,亞玲姐,你回來了? 啊!還有我姐,劉哥,我們三個人呢。 </s></s> 跟我一塊走唄!</s>	joy	joy
<s> 用車嗎? 狗剩子!你也在這兒? 是呀,亞玲姐,你回來了? 啊!還有我姐,劉哥,我們三個人呢。 跟我一塊走唄! </s></s> 行啊!車在哪兒呢?</s>	joy	joy
<s> 用車嗎? 狗剩子!你也在這兒? 是呀,亞玲姐,你回來了? 啊!還有我姐,劉哥,我們三個人呢。 跟我一塊走唄! 行啊!車在哪兒呢? </s></s> 就在前邊。</s>	neutral	joy
<s> 用車嗎? 狗剩子!你也在這兒? 是呀,亞玲姐,你回來了? 啊!還有我姐,劉哥,我們三個人呢。 跟我一塊走唄! 行啊!車在哪兒呢? 就在前邊。 </s></s> 他是手扶拖拉機!</s>	neutral	surprise
<s> 用車嗎? 狗剩子!你也在這兒? 是呀,亞玲姐,你回來了? 啊!還有我姐,劉哥,我們三個人呢。 跟我一塊走唄! 行啊!車在哪兒呢? 就在前邊。 他是手扶拖拉機! </s></s> 那有啥關係?能拉人就行唄。狗剩子,你還得等一會兒,我們得把包裹提出來。</s>	neutral	surprise
<s> 用車嗎? 狗剩子!你也在這兒? 是呀,亞玲姐,你回來了? 啊!還有我姐,劉哥,我們三個人呢。 跟我一塊走唄! 行啊!車在哪兒呢? 就在前邊。 他是手扶拖拉機! 那有啥關係?能拉人就行唄。狗剩子,你還得等一會兒,我們得把包裹提出來。 </s></s> 行!你們去提吧,我把車開過來。</s>	neutral	joy
<s></s></s> 坐好了,啊!</s>	neutral	joy
<s> 坐好了,啊! </s></s> 好啦!狗剩,先上劉哥的店!</s>	joy	joy
<s> 坐好了,啊! 好啦!狗剩,先上劉哥的店! </s></s> 知道!</s>	neutral	joy
<s></s></s> 亞玲姐!你們回來了?</s>	surprise	surprise
<s> 亞玲姐!你們回來了? </s></s> 回來了!</s>	joy	joy
<s> 亞玲姐!你們回來了? 回來了! </s></s> 多少錢?</s>	neutral	surprise
<s> 亞玲姐!你們回來了? 回來了! 多少錢? </s></s> 我們一塊給吧,我們的東西多。</s>	joy	joy
<s> 亞玲姐!你們回來了? 回來了! 多少錢? 我們一塊給吧,我們的東西多。 </s></s> 咱們一家一半吧?</s>	joy	surprise
<s> 亞玲姐!你們回來了? 回來了! 多少錢? 我們一塊給吧,我們的東西多。 咱們一家一半吧? </s></s> 得了吧!下次你再給。狗剩子,開車!</s>	joy	joy
<s> 亞玲姐!你們回來了? 回來了! 多少錢? 我們一塊給吧,我們的東西多。 咱們一家一半吧? 得了吧!下次你再給。狗剩子,開車! </s></s> 那就謝謝了!</s>	joy	joy
<s> 亞玲姐!你們回來了? 回來了! 多少錢? 我們一塊給吧,我們的東西多。 咱們一家一半吧? 得了吧!下次你再給。狗剩子,開車! 那就謝謝了! </s></s> 謝謝亞玲姐!來玩啊!</s>	joy	joy
<s></s></s> 多少錢?</s>	surprise	surprise
<s> 多少錢? </s></s> 隨便!不給也行。</s>	joy	joy
<s> 多少錢? 隨便!不給也行。 </s></s> 那我真不給!</s>	angry	joy
<s> 多少錢? 隨便!不給也行。 那我真不給! </s></s> 不給就不給,請我上歌廳聽個歌就行了。</s>	joy	joy
<s> 多少錢? 隨便!不給也行。 那我真不給! 不給就不給,請我上歌廳聽個歌就行了。 </s></s> 美的你!總共給你五塊錢吧!</s>	joy	joy
<s> 多少錢? 隨便!不給也行。 那我真不給! 不給就不給,請我上歌廳聽個歌就行了。 美的你!總共給你五塊錢吧! </s></s> 行!</s>	joy	joy
<s></s></s> 劉傑!</s>	surprise	joy
<s> 劉傑! </s></s> 亞玲姐來啦!</s>	joy	joy
<s> 劉傑! 亞玲姐來啦! </s></s> 劉傑呢?</s>	surprise	surprise
<s> 劉傑! 亞玲姐來啦! 劉傑呢? </s></s> 他在,劉傑!</s>	joy	joy
<s></s></s> 亞玲!有事兒嗎?</s>	surprise	joy
<s> 亞玲!有事兒嗎? </s></s> 給你照片。</s>	neutral	joy
<s></s></s> 這麼快就寄來了?</s>	surprise	surprise
<s> 這麼快就寄來了? </s></s> 是呀,人家當天就寄出來,第二天就到了。</s>	joy	joy
<s> 這麼快就寄來了? 是呀,人家當天就寄出來,第二天就到了。 </s></s> 啥照片?我看。</s>	surprise	joy
<s></s></s> 這是在哪兒照的呀?</s>	surprise	surprise
<s> 這是在哪兒照的呀? </s></s> 在楊子榮陵園。</s>	neutral	joy
<s> 這是在哪兒照的呀? 在楊子榮陵園。 </s></s> 啥陵園?</s>	surprise	surprise
<s> 這是在哪兒照的呀? 在楊子榮陵園。 啥陵園? </s></s> 楊子榮陵園。</s>	neutral	neutral
<s> 這是在哪兒照的呀? 在楊子榮陵園。 啥陵園? 楊子榮陵園。 </s></s> 楊子榮陵園在哪兒呀?</s>	surprise	surprise
<s> 這是在哪兒照的呀? 在楊子榮陵園。 啥陵園? 楊子榮陵園。 楊子榮陵園在哪兒呀? </s></s> 在海林。</s>	neutral	joy
<s> 這是在哪兒照的呀? 在楊子榮陵園。 啥陵園? 楊子榮陵園。 楊子榮陵園在哪兒呀? 在海林。 </s></s> 海林?你們不是上綏芬河去了嗎?</s>	surprise	surprise
<s> 這是在哪兒照的呀? 在楊子榮陵園。 啥陵園? 楊子榮陵園。 楊子榮陵園在哪兒呀? 在海林。 海林?你們不是上綏芬河去了嗎? </s></s> 上綏芬河路過海林,我們就在哪下了一會兒車。</s>	neutral	joy
<s> 這是在哪兒照的呀? 在楊子榮陵園。 啥陵園? 楊子榮陵園。 楊子榮陵園在哪兒呀? 在海林。 海林?你們不是上綏芬河去了嗎? 上綏芬河路過海林,我們就在哪下了一會兒車。 </s></s> 噢。</s>	surprise	neutral
<s> 這是在哪兒照的呀? 在楊子榮陵園。 啥陵園? 楊子榮陵園。 楊子榮陵園在哪兒呀? 在海林。 海林?你們不是上綏芬河去了嗎? 上綏芬河路過海林,我們就在哪下了一會兒車。 噢。 </s></s> 多少錢?我給你錢。</s>	joy	surprise
<s> 這是在哪兒照的呀? 在楊子榮陵園。 啥陵園? 楊子榮陵園。 楊子榮陵園在哪兒呀? 在海林。 海林?你們不是上綏芬河去了嗎? 上綏芬河路過海林,我們就在哪下了一會兒車。 噢。 多少錢?我給你錢。 </s></s> 不用給錢。</s>	neutral	joy
<s> 在楊子榮陵園。 啥陵園? 楊子榮陵園。 楊子榮陵園在哪兒呀? 在海林。 海林?你們不是上綏芬河去了嗎? 上綏芬河路過海林,我們就在哪下了一會兒車。 噢。 多少錢?我給你錢。 不用給錢。 </s></s> 那謝謝你。</s>	joy	joy
<s> 啥陵園? 楊子榮陵園。 楊子榮陵園在哪兒呀? 在海林。 海林?你們不是上綏芬河去了嗎? 上綏芬河路過海林,我們就在哪下了一會兒車。 噢。 多少錢?我給你錢。 不用給錢。 那謝謝你。 </s></s> 也不用謝,你請我喝杯茶就行了。</s>	joy	joy
<s> 楊子榮陵園。 楊子榮陵園在哪兒呀? 在海林。 海林?你們不是上綏芬河去了嗎? 上綏芬河路過海林,我們就在哪下了一會兒車。 噢。 多少錢?我給你錢。 不用給錢。 那謝謝你。 也不用謝,你請我喝杯茶就行了。 </s></s> 行,娟子,給亞玲倒杯茶。</s>	joy	joy
<s> 楊子榮陵園在哪兒呀? 在海林。 海林?你們不是上綏芬河去了嗎? 上綏芬河路過海林,我們就在哪下了一會兒車。 噢。 多少錢?我給你錢。 不用給錢。 那謝謝你。 也不用謝,你請我喝杯茶就行了。 行,娟子,給亞玲倒杯茶。 </s></s> 不在這喝。在“”</s>	neutral	joy
<s> 在海林。 海林?你們不是上綏芬河去了嗎? 上綏芬河路過海林,我們就在哪下了一會兒車。 噢。 多少錢?我給你錢。 不用給錢。 那謝謝你。 也不用謝,你請我喝杯茶就行了。 行,娟子,給亞玲倒杯茶。 不在這喝。在“” </s></s> 在哪兒喝呀?</s>	surprise	surprise
<s> 海林?你們不是上綏芬河去了嗎? 上綏芬河路過海林,我們就在哪下了一會兒車。 噢。 多少錢?我給你錢。 不用給錢。 那謝謝你。 也不用謝,你請我喝杯茶就行了。 行,娟子,給亞玲倒杯茶。 不在這喝。在“” 在哪兒喝呀? </s></s> 在歌廳呀,一邊喝茶一邊唱歌,那多好。</s>	joy	joy
<s> 上綏芬河路過海林,我們就在哪下了一會兒車。 噢。 多少錢?我給你錢。 不用給錢。 那謝謝你。 也不用謝,你請我喝杯茶就行了。 行,娟子,給亞玲倒杯茶。 不在這喝。在“” 在哪兒喝呀? 在歌廳呀,一邊喝茶一邊唱歌,那多好。 </s></s> 行,等我有時間的。</s>	joy	joy
<s> 噢。 多少錢?我給你錢。 不用給錢。 那謝謝你。 也不用謝,你請我喝杯茶就行了。 行,娟子,給亞玲倒杯茶。 不在這喝。在“” 在哪兒喝呀? 在歌廳呀,一邊喝茶一邊唱歌,那多好。 行,等我有時間的。 </s></s> 好,我等着,拜拜!</s>	joy	joy
<s></s></s> 這咋還男的女的在一塊照呢?</s>	surprise	angry
<s> 這咋還男的女的在一塊照呢? </s></s> 現在男的女的在一塊照相還不常見?</s>	surprise	neutral
<s> 這咋還男的女的在一塊照呢? 現在男的女的在一塊照相還不常見? </s></s> 你自己照一個多好,還有紀念意義。</s>	joy	disgust
<s> 這咋還男的女的在一塊照呢? 現在男的女的在一塊照相還不常見? 你自己照一個多好,還有紀念意義。 </s></s> 本來我就沒想照,她們說來了就照一個吧。我說我沒開票,她們說一塊照一個得了,省得再去開票,我就照了。</s>	joy	neutral
<s> 這咋還男的女的在一塊照呢? 現在男的女的在一塊照相還不常見? 你自己照一個多好,還有紀念意義。 本來我就沒想照,她們說來了就照一個吧。我說我沒開票,她們說一塊照一個得了,省得再去開票,我就照了。 </s></s> 下次我也去!,去玩去照相!</s>	joy	joy
<s> 這咋還男的女的在一塊照呢? 現在男的女的在一塊照相還不常見? 你自己照一個多好,還有紀念意義。 本來我就沒想照,她們說來了就照一個吧。我說我沒開票,她們說一塊照一個得了,省得再去開票,我就照了。 下次我也去!,去玩去照相! </s></s> 是,我們說好了,下次在綏芬河住下好好玩幾天。</s>	joy	joy
<s> 這咋還男的女的在一塊照呢? 現在男的女的在一塊照相還不常見? 你自己照一個多好,還有紀念意義。 本來我就沒想照,她們說來了就照一個吧。我說我沒開票,她們說一塊照一個得了,省得再去開票,我就照了。 下次我也去!,去玩去照相! 是,我們說好了,下次在綏芬河住下好好玩幾天。 </s></s> 你們還要去?</s>	surprise	surprise
<s> 這咋還男的女的在一塊照呢? 現在男的女的在一塊照相還不常見? 你自己照一個多好,還有紀念意義。 本來我就沒想照,她們說來了就照一個吧。我說我沒開票,她們說一塊照一個得了,省得再去開票,我就照了。 下次我也去!,去玩去照相! 是,我們說好了,下次在綏芬河住下好好玩幾天。 你們還要去? </s></s> 是呀,下次把你也帶去,專門去玩一趟。</s>	joy	joy
<s> 這咋還男的女的在一塊照呢? 現在男的女的在一塊照相還不常見? 你自己照一個多好,還有紀念意義。 本來我就沒想照,她們說來了就照一個吧。我說我沒開票,她們說一塊照一個得了,省得再去開票,我就照了。 下次我也去!,去玩去照相! 是,我們說好了,下次在綏芬河住下好好玩幾天。 你們還要去? 是呀,下次把你也帶去,專門去玩一趟。 </s></s> 哼!</s>	angry	joy
<s></s></s> 這一臺就是對開套色印刷機嗎?</s>	surprise	surprise
<s> 這一臺就是對開套色印刷機嗎? </s></s> 對。我們這種機型也有點老,要買還是儘可能買新型的,多花點錢也值,不然過一陣子又淘汰了。又“”色印刷機</s>	neutral	fear
<s> 這一臺就是對開套色印刷機嗎? 對。我們這種機型也有點老,要買還是儘可能買新型的,多花點錢也值,不然過一陣子又淘汰了。又“”色印刷機 </s></s> 我們買的就是這種機型吧?</s>	joy	surprise
<s> 這一臺就是對開套色印刷機嗎? 對。我們這種機型也有點老,要買還是儘可能買新型的,多花點錢也值,不然過一陣子又淘汰了。又“”色印刷機 我們買的就是這種機型吧? </s></s> 你們的比這臺強多了!</s>	joy	surprise
<s></s></s> 娟子,今天是星期一,咱們上歌廳去唱歌吧?</s>	joy	joy
<s> 娟子,今天是星期一,咱們上歌廳去唱歌吧? </s></s> 不作生意了?</s>	surprise	surprise
<s> 娟子,今天是星期一,咱們上歌廳去唱歌吧? 不作生意了? </s></s> 禮拜一,買賣稀,反正今天也不會有多少生意可作,就歇一天唄。</s>	neutral	joy
<s> 娟子,今天是星期一,咱們上歌廳去唱歌吧? 不作生意了? 禮拜一,買賣稀,反正今天也不會有多少生意可作,就歇一天唄。 </s></s> 咱可是從來都沒關過門的。</s>	neutral	fear
<s> 娟子,今天是星期一,咱們上歌廳去唱歌吧? 不作生意了? 禮拜一,買賣稀,反正今天也不會有多少生意可作,就歇一天唄。 咱可是從來都沒關過門的。 </s></s> 也不用關門,早點下班就是了。</s>	joy	joy
<s> 娟子,今天是星期一,咱們上歌廳去唱歌吧? 不作生意了? 禮拜一,買賣稀,反正今天也不會有多少生意可作,就歇一天唄。 咱可是從來都沒關過門的。 也不用關門,早點下班就是了。 </s></s> 你去吧,我在家看店。</s>	joy	disgust
<s> 娟子,今天是星期一,咱們上歌廳去唱歌吧? 不作生意了? 禮拜一,買賣稀,反正今天也不會有多少生意可作,就歇一天唄。 咱可是從來都沒關過門的。 也不用關門,早點下班就是了。 你去吧,我在家看店。 </s></s> 一塊去唄。</s>	joy	joy
<s> 娟子,今天是星期一,咱們上歌廳去唱歌吧? 不作生意了? 禮拜一,買賣稀,反正今天也不會有多少生意可作,就歇一天唄。 咱可是從來都沒關過門的。 也不用關門,早點下班就是了。 你去吧,我在家看店。 一塊去唄。 </s></s> 你怎麼忽然想起來去唱歌了呢?</s>	surprise	surprise
<s> 娟子,今天是星期一,咱們上歌廳去唱歌吧? 不作生意了? 禮拜一,買賣稀,反正今天也不會有多少生意可作,就歇一天唄。 咱可是從來都沒關過門的。 也不用關門,早點下班就是了。 你去吧,我在家看店。 一塊去唄。 你怎麼忽然想起來去唱歌了呢? </s></s> 不是我想唱歌。我是要請亞玲去唱歌。咱們不是還欠人家一個人情呢嗎?</s>	neutral	joy
<s> 娟子,今天是星期一,咱們上歌廳去唱歌吧? 不作生意了? 禮拜一,買賣稀,反正今天也不會有多少生意可作,就歇一天唄。 咱可是從來都沒關過門的。 也不用關門,早點下班就是了。 你去吧,我在家看店。 一塊去唄。 你怎麼忽然想起來去唱歌了呢? 不是我想唱歌。我是要請亞玲去唱歌。咱們不是還欠人家一個人情呢嗎? </s></s> 咱們欠她什麼情?</s>	disgust	surprise
<s> 娟子,今天是星期一,咱們上歌廳去唱歌吧? 不作生意了? 禮拜一,買賣稀,反正今天也不會有多少生意可作,就歇一天唄。 咱可是從來都沒關過門的。 也不用關門,早點下班就是了。 你去吧,我在家看店。 一塊去唄。 你怎麼忽然想起來去唱歌了呢? 不是我想唱歌。我是要請亞玲去唱歌。咱們不是還欠人家一個人情呢嗎? 咱們欠她什麼情? </s></s> 你忘了?她們帶我上綏芬河去進貨,還替我買票。我答應請她們去唱歌了。</s>	joy	surprise
<s> 不作生意了? 禮拜一,買賣稀,反正今天也不會有多少生意可作,就歇一天唄。 咱可是從來都沒關過門的。 也不用關門,早點下班就是了。 你去吧,我在家看店。 一塊去唄。 你怎麼忽然想起來去唱歌了呢? 不是我想唱歌。我是要請亞玲去唱歌。咱們不是還欠人家一個人情呢嗎? 咱們欠她什麼情? 你忘了?她們帶我上綏芬河去進貨,還替我買票。我答應請她們去唱歌了。 </s></s> 那就去唄。</s>	joy	neutral
<s> 禮拜一,買賣稀,反正今天也不會有多少生意可作,就歇一天唄。 咱可是從來都沒關過門的。 也不用關門,早點下班就是了。 你去吧,我在家看店。 一塊去唄。 你怎麼忽然想起來去唱歌了呢? 不是我想唱歌。我是要請亞玲去唱歌。咱們不是還欠人家一個人情呢嗎? 咱們欠她什麼情? 你忘了?她們帶我上綏芬河去進貨,還替我買票。我答應請她們去唱歌了。 那就去唄。 </s></s> 你帶點錢,我去約她們。</s>	neutral	joy
<s></s></s> 你們可是姍姍來遲呀。</s>	surprise	angry
<s> 你們可是姍姍來遲呀。 </s></s> 剛打發走一個客人,他一走我們趕緊把門關了。</s>	neutral	joy
<s> 你們可是姍姍來遲呀。 剛打發走一個客人,他一走我們趕緊把門關了。 </s></s> 亞玲姐,你好!</s>	joy	joy
<s> 你們可是姍姍來遲呀。 剛打發走一個客人,他一走我們趕緊把門關了。 亞玲姐,你好! </s></s> 你好。姐,我給你介紹,這是劉哥的愛人娟子,多漂亮的小姑娘。這是我姐亞琳。</s>	joy	joy
<s> 你們可是姍姍來遲呀。 剛打發走一個客人,他一走我們趕緊把門關了。 亞玲姐,你好! 你好。姐,我給你介紹,這是劉哥的愛人娟子,多漂亮的小姑娘。這是我姐亞琳。 </s></s> 亞玲姐,你好。</s>	joy	joy
<s> 你們可是姍姍來遲呀。 剛打發走一個客人,他一走我們趕緊把門關了。 亞玲姐,你好! 你好。姐,我給你介紹,這是劉哥的愛人娟子,多漂亮的小姑娘。這是我姐亞琳。 亞玲姐,你好。 </s></s> 不是亞玲,是亞琳,琳琅滿目的琳。我是玲瓏的玲。</s>	joy	joy
<s> 你們可是姍姍來遲呀。 剛打發走一個客人,他一走我們趕緊把門關了。 亞玲姐,你好! 你好。姐,我給你介紹,這是劉哥的愛人娟子,多漂亮的小姑娘。這是我姐亞琳。 亞玲姐,你好。 不是亞玲,是亞琳,琳琅滿目的琳。我是玲瓏的玲。 </s></s> 亞琳姐。</s>	joy	joy
<s> 你們可是姍姍來遲呀。 剛打發走一個客人,他一走我們趕緊把門關了。 亞玲姐,你好! 你好。姐,我給你介紹,這是劉哥的愛人娟子,多漂亮的小姑娘。這是我姐亞琳。 亞玲姐,你好。 不是亞玲,是亞琳,琳琅滿目的琳。我是玲瓏的玲。 亞琳姐。 </s></s> 你好,娟子。</s>	joy	joy
<s></s></s> 咱們進去吧。</s>	neutral	joy
<s> 咱們進去吧。 </s></s> 走吧,咱們進去再聊。</s>	joy	joy
<s></s></s> 今天影響你們營業了,不好意思。</s>	neutral	fear
<s> 今天影響你們營業了,不好意思。 </s></s> 你們不也一樣嗎?</s>	surprise	joy
<s> 今天影響你們營業了,不好意思。 你們不也一樣嗎? </s></s> 咱們也該給自個兒放個假了,幹嘛一天到晚一年到頭沒完沒了的?</s>	disgust	joy
<s> 今天影響你們營業了,不好意思。 你們不也一樣嗎? 咱們也該給自個兒放個假了,幹嘛一天到晚一年到頭沒完沒了的? </s></s> 咱們幹個體的,有這個自由,想哪天歇就哪天歇,想放假就放假。</s>	joy	joy
<s> 今天影響你們營業了,不好意思。 你們不也一樣嗎? 咱們也該給自個兒放個假了,幹嘛一天到晚一年到頭沒完沒了的? 咱們幹個體的,有這個自由,想哪天歇就哪天歇,想放假就放假。 </s></s> 也不能想放假就放假。隨便放假不但影響自己的利益,也給消費者帶來不便。人家想買什麼東西了,別家沒有,只你家有,碰巧你又關門,那不是耽誤人家的事嗎?</s>	surprise	fear
<s> 今天影響你們營業了,不好意思。 你們不也一樣嗎? 咱們也該給自個兒放個假了,幹嘛一天到晚一年到頭沒完沒了的? 咱們幹個體的,有這個自由,想哪天歇就哪天歇,想放假就放假。 也不能想放假就放假。隨便放假不但影響自己的利益,也給消費者帶來不便。人家想買什麼東西了,別家沒有,只你家有,碰巧你又關門,那不是耽誤人家的事嗎? </s></s> 活該!這誰管得着?</s>	disgust	disgust
<s> 今天影響你們營業了,不好意思。 你們不也一樣嗎? 咱們也該給自個兒放個假了,幹嘛一天到晚一年到頭沒完沒了的? 咱們幹個體的,有這個自由,想哪天歇就哪天歇,想放假就放假。 也不能想放假就放假。隨便放假不但影響自己的利益,也給消費者帶來不便。人家想買什麼東西了,別家沒有,只你家有,碰巧你又關門,那不是耽誤人家的事嗎? 活該!這誰管得着? </s></s> 不應該管不着。你開店營業,那是經過批准的。你進入市場了就得遵守市場規矩。你不守規矩那就有人管。</s>	neutral	disgust
<s> 今天影響你們營業了,不好意思。 你們不也一樣嗎? 咱們也該給自個兒放個假了,幹嘛一天到晚一年到頭沒完沒了的? 咱們幹個體的,有這個自由,想哪天歇就哪天歇,想放假就放假。 也不能想放假就放假。隨便放假不但影響自己的利益,也給消費者帶來不便。人家想買什麼東西了,別家沒有,只你家有,碰巧你又關門,那不是耽誤人家的事嗎? 活該!這誰管得着? 不應該管不着。你開店營業,那是經過批准的。你進入市場了就得遵守市場規矩。你不守規矩那就有人管。 </s></s> 這種事沒人管,又不是偷稅漏稅。</s>	angry	disgust
<s> 今天影響你們營業了,不好意思。 你們不也一樣嗎? 咱們也該給自個兒放個假了,幹嘛一天到晚一年到頭沒完沒了的? 咱們幹個體的,有這個自由,想哪天歇就哪天歇,想放假就放假。 也不能想放假就放假。隨便放假不但影響自己的利益,也給消費者帶來不便。人家想買什麼東西了,別家沒有,只你家有,碰巧你又關門,那不是耽誤人家的事嗎? 活該!這誰管得着? 不應該管不着。你開店營業,那是經過批准的。你進入市場了就得遵守市場規矩。你不守規矩那就有人管。 這種事沒人管,又不是偷稅漏稅。 </s></s> 這說明咱們的市場不健全。</s>	neutral	disgust
<s></s></s> 娟子,你幾歲了?</s>	neutral	surprise
<s> 娟子,你幾歲了? </s></s> 還幾歲了,我都二十了。</s>	neutral	joy
<s> 娟子,你幾歲了? 還幾歲了,我都二十了。 </s></s> 看起來二十都不像,像個孩子。有小孩嗎?</s>	surprise	surprise
<s> 娟子,你幾歲了? 還幾歲了,我都二十了。 看起來二十都不像,像個孩子。有小孩嗎? </s></s> 還沒有,剛結婚。</s>	neutral	joy
<s> 娟子,你幾歲了? 還幾歲了,我都二十了。 看起來二十都不像,像個孩子。有小孩嗎? 還沒有,剛結婚。 </s></s> 幹嘛這麼早結婚呀?</s>	surprise	surprise
<s> 娟子,你幾歲了? 還幾歲了,我都二十了。 看起來二十都不像,像個孩子。有小孩嗎? 還沒有,剛結婚。 幹嘛這麼早結婚呀? </s></s> 是有點早,不過,反正是一家人,早點也無所謂。</s>	joy	joy
<s> 娟子,你幾歲了? 還幾歲了,我都二十了。 看起來二十都不像,像個孩子。有小孩嗎? 還沒有,剛結婚。 幹嘛這麼早結婚呀? 是有點早,不過,反正是一家人,早點也無所謂。 </s></s> 怎麼是一家人?</s>	surprise	surprise
<s> 娟子,你幾歲了? 還幾歲了,我都二十了。 看起來二十都不像,像個孩子。有小孩嗎? 還沒有,剛結婚。 幹嘛這麼早結婚呀? 是有點早,不過,反正是一家人,早點也無所謂。 怎麼是一家人? </s></s> 他是我表哥。</s>	joy	neutral
<s> 娟子,你幾歲了? 還幾歲了,我都二十了。 看起來二十都不像,像個孩子。有小孩嗎? 還沒有,剛結婚。 幹嘛這麼早結婚呀? 是有點早,不過,反正是一家人,早點也無所謂。 怎麼是一家人? 他是我表哥。 </s></s> 表哥?</s>	surprise	surprise
<s> 娟子,你幾歲了? 還幾歲了,我都二十了。 看起來二十都不像,像個孩子。有小孩嗎? 還沒有,剛結婚。 幹嘛這麼早結婚呀? 是有點早,不過,反正是一家人,早點也無所謂。 怎麼是一家人? 他是我表哥。 表哥? </s></s> 他媽是我大姨。</s>	joy	neutral
<s> 娟子,你幾歲了? 還幾歲了,我都二十了。 看起來二十都不像,像個孩子。有小孩嗎? 還沒有,剛結婚。 幹嘛這麼早結婚呀? 是有點早,不過,反正是一家人,早點也無所謂。 怎麼是一家人? 他是我表哥。 表哥? 他媽是我大姨。 </s></s> 噢,那不是近親結婚嗎?</s>	surprise	surprise
<s> 還幾歲了,我都二十了。 看起來二十都不像,像個孩子。有小孩嗎? 還沒有,剛結婚。 幹嘛這麼早結婚呀? 是有點早,不過,反正是一家人,早點也無所謂。 怎麼是一家人? 他是我表哥。 表哥? 他媽是我大姨。 噢,那不是近親結婚嗎? </s></s> 是近親還不好?親上加親。</s>	disgust	surprise
<s></s></s> 你不常來跳舞嗎?</s>	surprise	surprise
<s> 你不常來跳舞嗎? </s></s> 咱們作生意的,誰捨得上這來呀?</s>	joy	sadness
<s> 你不常來跳舞嗎? 咱們作生意的,誰捨得上這來呀? </s></s> 捨不得錢呀還是捨不得時間?</s>	joy	joy
<s> 你不常來跳舞嗎? 咱們作生意的,誰捨得上這來呀? 捨不得錢呀還是捨不得時間? </s></s> 都有點捨不得。</s>	joy	joy
<s> 你不常來跳舞嗎? 咱們作生意的,誰捨得上這來呀? 捨不得錢呀還是捨不得時間? 都有點捨不得。 </s></s> 那你可錯了。你捨不得的都是小頭,卻把大頭都舍了。</s>	joy	disgust
<s> 你不常來跳舞嗎? 咱們作生意的,誰捨得上這來呀? 捨不得錢呀還是捨不得時間? 都有點捨不得。 那你可錯了。你捨不得的都是小頭,卻把大頭都舍了。 </s></s> 啥大頭?</s>	surprise	surprise
<s> 你不常來跳舞嗎? 咱們作生意的,誰捨得上這來呀? 捨不得錢呀還是捨不得時間? 都有點捨不得。 那你可錯了。你捨不得的都是小頭,卻把大頭都舍了。 啥大頭? </s></s> 青春呀。你想,一個人青春有幾何?趁年輕的時候再不玩一玩,到老了後悔都來不及了。</s>	joy	joy
<s> 你不常來跳舞嗎? 咱們作生意的,誰捨得上這來呀? 捨不得錢呀還是捨不得時間? 都有點捨不得。 那你可錯了。你捨不得的都是小頭,卻把大頭都舍了。 啥大頭? 青春呀。你想,一個人青春有幾何?趁年輕的時候再不玩一玩,到老了後悔都來不及了。 </s></s> 趁年輕才應該掙點錢呢。</s>	joy	disgust
<s> 你不常來跳舞嗎? 咱們作生意的,誰捨得上這來呀? 捨不得錢呀還是捨不得時間? 都有點捨不得。 那你可錯了。你捨不得的都是小頭,卻把大頭都舍了。 啥大頭? 青春呀。你想,一個人青春有幾何?趁年輕的時候再不玩一玩,到老了後悔都來不及了。 趁年輕才應該掙點錢呢。 </s></s> 沒錯,應該掙錢,但掙了錢就應該花,要不花不享受,那掙錢還有什麼意義?</s>	disgust	joy
<s> 你不常來跳舞嗎? 咱們作生意的,誰捨得上這來呀? 捨不得錢呀還是捨不得時間? 都有點捨不得。 那你可錯了。你捨不得的都是小頭,卻把大頭都舍了。 啥大頭? 青春呀。你想,一個人青春有幾何?趁年輕的時候再不玩一玩,到老了後悔都來不及了。 趁年輕才應該掙點錢呢。 沒錯,應該掙錢,但掙了錢就應該花,要不花不享受,那掙錢還有什麼意義? </s></s> 說是這麼說。</s>	neutral	neutral
<s> 你不常來跳舞嗎? 咱們作生意的,誰捨得上這來呀? 捨不得錢呀還是捨不得時間? 都有點捨不得。 那你可錯了。你捨不得的都是小頭,卻把大頭都舍了。 啥大頭? 青春呀。你想,一個人青春有幾何?趁年輕的時候再不玩一玩,到老了後悔都來不及了。 趁年輕才應該掙點錢呢。 沒錯,應該掙錢,但掙了錢就應該花,要不花不享受,那掙錢還有什麼意義? 說是這麼說。 </s></s> 這麼說了咱就這麼做,以後咱們每個禮拜來一次,唱歌跳舞,怎麼樣?</s>	joy	joy
<s> 咱們作生意的,誰捨得上這來呀? 捨不得錢呀還是捨不得時間? 都有點捨不得。 那你可錯了。你捨不得的都是小頭,卻把大頭都舍了。 啥大頭? 青春呀。你想,一個人青春有幾何?趁年輕的時候再不玩一玩,到老了後悔都來不及了。 趁年輕才應該掙點錢呢。 沒錯,應該掙錢,但掙了錢就應該花,要不花不享受,那掙錢還有什麼意義? 說是這麼說。 這麼說了咱就這麼做,以後咱們每個禮拜來一次,唱歌跳舞,怎麼樣? </s></s> 那可不行,太多了。</s>	joy	disgust
<s> 捨不得錢呀還是捨不得時間? 都有點捨不得。 那你可錯了。你捨不得的都是小頭,卻把大頭都舍了。 啥大頭? 青春呀。你想,一個人青春有幾何?趁年輕的時候再不玩一玩,到老了後悔都來不及了。 趁年輕才應該掙點錢呢。 沒錯,應該掙錢,但掙了錢就應該花,要不花不享受,那掙錢還有什麼意義? 說是這麼說。 這麼說了咱就這麼做,以後咱們每個禮拜來一次,唱歌跳舞,怎麼樣? 那可不行,太多了。 </s></s> 一個月來一次?</s>	surprise	joy
<s></s></s> 哼,真扣門兒!我還想出國旅遊呢。</s>	disgust	disgust
<s> 哼,真扣門兒!我還想出國旅遊呢。 </s></s> 唉,太奢侈了。</s>	joy	fear
<s> 哼,真扣門兒!我還想出國旅遊呢。 唉,太奢侈了。 </s></s> 劉哥,你咋沒上林業局去上班呢?</s>	surprise	surprise
<s> 哼,真扣門兒!我還想出國旅遊呢。 唉,太奢侈了。 劉哥,你咋沒上林業局去上班呢? </s></s> 那林業局是誰想去就能去的嗎?</s>	surprise	disgust
<s> 哼,真扣門兒!我還想出國旅遊呢。 唉,太奢侈了。 劉哥,你咋沒上林業局去上班呢? 那林業局是誰想去就能去的嗎? </s></s> 別人不能去,你應該能去呀?</s>	joy	surprise
<s> 哼,真扣門兒!我還想出國旅遊呢。 唉,太奢侈了。 劉哥,你咋沒上林業局去上班呢? 那林業局是誰想去就能去的嗎? 別人不能去,你應該能去呀? </s></s> 我有啥跟別人不一樣的嗎?</s>	neutral	surprise
<s> 哼,真扣門兒!我還想出國旅遊呢。 唉,太奢侈了。 劉哥,你咋沒上林業局去上班呢? 那林業局是誰想去就能去的嗎? 別人不能去,你應該能去呀? 我有啥跟別人不一樣的嗎? </s></s> 你不是大學生嗎?</s>	surprise	surprise
<s> 哼,真扣門兒!我還想出國旅遊呢。 唉,太奢侈了。 劉哥,你咋沒上林業局去上班呢? 那林業局是誰想去就能去的嗎? 別人不能去,你應該能去呀? 我有啥跟別人不一樣的嗎? 你不是大學生嗎? </s></s> 誰說我是大學生?</s>	disgust	surprise
<s> 哼,真扣門兒!我還想出國旅遊呢。 唉,太奢侈了。 劉哥,你咋沒上林業局去上班呢? 那林業局是誰想去就能去的嗎? 別人不能去,你應該能去呀? 我有啥跟別人不一樣的嗎? 你不是大學生嗎? 誰說我是大學生? </s></s> 你不是大學生,是中專生高中生也行啊。</s>	joy	neutral
<s> 哼,真扣門兒!我還想出國旅遊呢。 唉,太奢侈了。 劉哥,你咋沒上林業局去上班呢? 那林業局是誰想去就能去的嗎? 別人不能去,你應該能去呀? 我有啥跟別人不一樣的嗎? 你不是大學生嗎? 誰說我是大學生? 你不是大學生,是中專生高中生也行啊。 </s></s> 裏邊沒有人什麼生也白搭。</s>	disgust	disgust
<s> 哼,真扣門兒!我還想出國旅遊呢。 唉,太奢侈了。 劉哥,你咋沒上林業局去上班呢? 那林業局是誰想去就能去的嗎? 別人不能去,你應該能去呀? 我有啥跟別人不一樣的嗎? 你不是大學生嗎? 誰說我是大學生? 你不是大學生,是中專生高中生也行啊。 裏邊沒有人什麼生也白搭。 </s></s> 那倒也是。不過進去了也沒啥意思,現在正裁人呢,半道給裁下來還不如不去呢。還不如咱們自己幹穩當。</s>	neutral	joy
<s></s></s> 哎,你們看,那不是他們倆嗎?</s>	surprise	surprise
<s> 哎,你們看,那不是他們倆嗎? </s></s> 誰倆?</s>	surprise	surprise
<s> 哎,你們看,那不是他們倆嗎? 誰倆? </s></s> 林業局的會計跟出納。</s>	neutral	surprise
<s> 哎,你們看,那不是他們倆嗎? 誰倆? 林業局的會計跟出納。 </s></s> 他們倆咋的了?</s>	surprise	surprise
<s> 哎,你們看,那不是他們倆嗎? 誰倆? 林業局的會計跟出納。 他們倆咋的了? </s></s> 把林業局的錢都給丟了,好幾萬呢!</s>	angry	surprise
<s> 哎,你們看,那不是他們倆嗎? 誰倆? 林業局的會計跟出納。 他們倆咋的了? 把林業局的錢都給丟了,好幾萬呢! </s></s> 林業局丟錢跟他倆有啥關係?</s>	surprise	surprise
<s> 哎,你們看,那不是他們倆嗎? 誰倆? 林業局的會計跟出納。 他們倆咋的了? 把林業局的錢都給丟了,好幾萬呢! 林業局丟錢跟他倆有啥關係? </s></s> 他倆一個會計一個出納,專門管錢的,兩人在一個辦公室,錢就是在他們辦公室丟的,還能沒關係?</s>	angry	disgust
<s> 哎,你們看,那不是他們倆嗎? 誰倆? 林業局的會計跟出納。 他們倆咋的了? 把林業局的錢都給丟了,好幾萬呢! 林業局丟錢跟他倆有啥關係? 他倆一個會計一個出納,專門管錢的,兩人在一個辦公室,錢就是在他們辦公室丟的,還能沒關係? </s></s> 聽說是從窗戶鑽進去的,把保險櫃都給撬開了。</s>	fear	neutral
<s> 哎,你們看,那不是他們倆嗎? 誰倆? 林業局的會計跟出納。 他們倆咋的了? 把林業局的錢都給丟了,好幾萬呢! 林業局丟錢跟他倆有啥關係? 他倆一個會計一個出納,專門管錢的,兩人在一個辦公室,錢就是在他們辦公室丟的,還能沒關係? 聽說是從窗戶鑽進去的,把保險櫃都給撬開了。 </s></s> 破案了嗎?</s>	surprise	surprise
<s> 哎,你們看,那不是他們倆嗎? 誰倆? 林業局的會計跟出納。 他們倆咋的了? 把林業局的錢都給丟了,好幾萬呢! 林業局丟錢跟他倆有啥關係? 他倆一個會計一個出納,專門管錢的,兩人在一個辦公室,錢就是在他們辦公室丟的,還能沒關係? 聽說是從窗戶鑽進去的,把保險櫃都給撬開了。 破案了嗎? </s></s> 上哪兒破去?早跑沒影兒了。</s>	neutral	disgust
<s> 哎,你們看,那不是他們倆嗎? 誰倆? 林業局的會計跟出納。 他們倆咋的了? 把林業局的錢都給丟了,好幾萬呢! 林業局丟錢跟他倆有啥關係? 他倆一個會計一個出納,專門管錢的,兩人在一個辦公室,錢就是在他們辦公室丟的,還能沒關係? 聽說是從窗戶鑽進去的,把保險櫃都給撬開了。 破案了嗎? 上哪兒破去?早跑沒影兒了。 </s></s> 他們辦公室存那麼多錢幹啥?</s>	surprise	surprise
<s> 誰倆? 林業局的會計跟出納。 他們倆咋的了? 把林業局的錢都給丟了,好幾萬呢! 林業局丟錢跟他倆有啥關係? 他倆一個會計一個出納,專門管錢的,兩人在一個辦公室,錢就是在他們辦公室丟的,還能沒關係? 聽說是從窗戶鑽進去的,把保險櫃都給撬開了。 破案了嗎? 上哪兒破去?早跑沒影兒了。 他們辦公室存那麼多錢幹啥? </s></s> 發工資。</s>	neutral	neutral
<s> 林業局的會計跟出納。 他們倆咋的了? 把林業局的錢都給丟了,好幾萬呢! 林業局丟錢跟他倆有啥關係? 他倆一個會計一個出納,專門管錢的,兩人在一個辦公室,錢就是在他們辦公室丟的,還能沒關係? 聽說是從窗戶鑽進去的,把保險櫃都給撬開了。 破案了嗎? 上哪兒破去?早跑沒影兒了。 他們辦公室存那麼多錢幹啥? 發工資。 </s></s> 你看,這邊發工資,小偷就來偷。小偷的消息咋那麼準呀?還不是有人給通消息?內外勾結!</s>	angry	angry
<s> 他們倆咋的了? 把林業局的錢都給丟了,好幾萬呢! 林業局丟錢跟他倆有啥關係? 他倆一個會計一個出納,專門管錢的,兩人在一個辦公室,錢就是在他們辦公室丟的,還能沒關係? 聽說是從窗戶鑽進去的,把保險櫃都給撬開了。 破案了嗎? 上哪兒破去?早跑沒影兒了。 他們辦公室存那麼多錢幹啥? 發工資。 你看,這邊發工資,小偷就來偷。小偷的消息咋那麼準呀?還不是有人給通消息?內外勾結! </s></s> 他們應該有保險櫃嘛,還能自動報警呢。</s>	neutral	neutral
<s> 把林業局的錢都給丟了,好幾萬呢! 林業局丟錢跟他倆有啥關係? 他倆一個會計一個出納,專門管錢的,兩人在一個辦公室,錢就是在他們辦公室丟的,還能沒關係? 聽說是從窗戶鑽進去的,把保險櫃都給撬開了。 破案了嗎? 上哪兒破去?早跑沒影兒了。 他們辦公室存那麼多錢幹啥? 發工資。 你看,這邊發工資,小偷就來偷。小偷的消息咋那麼準呀?還不是有人給通消息?內外勾結! 他們應該有保險櫃嘛,還能自動報警呢。 </s></s> 有了內應,什麼事不能辦呀?以前說不定丟了多少呢,這一回丟大發了纔不得不報案的。</s>	disgust	disgust
<s> 林業局丟錢跟他倆有啥關係? 他倆一個會計一個出納,專門管錢的,兩人在一個辦公室,錢就是在他們辦公室丟的,還能沒關係? 聽說是從窗戶鑽進去的,把保險櫃都給撬開了。 破案了嗎? 上哪兒破去?早跑沒影兒了。 他們辦公室存那麼多錢幹啥? 發工資。 你看,這邊發工資,小偷就來偷。小偷的消息咋那麼準呀?還不是有人給通消息?內外勾結! 他們應該有保險櫃嘛,還能自動報警呢。 有了內應,什麼事不能辦呀?以前說不定丟了多少呢,這一回丟大發了纔不得不報案的。 </s></s> 你看人家丟了那麼多,什麼事都沒有,還照樣跳舞唱歌。要是咱們呀,早得關店了。</s>	fear	sadness
<s> 他倆一個會計一個出納,專門管錢的,兩人在一個辦公室,錢就是在他們辦公室丟的,還能沒關係? 聽說是從窗戶鑽進去的,把保險櫃都給撬開了。 破案了嗎? 上哪兒破去?早跑沒影兒了。 他們辦公室存那麼多錢幹啥? 發工資。 你看,這邊發工資,小偷就來偷。小偷的消息咋那麼準呀?還不是有人給通消息?內外勾結! 他們應該有保險櫃嘛,還能自動報警呢。 有了內應,什麼事不能辦呀?以前說不定丟了多少呢,這一回丟大發了纔不得不報案的。 你看人家丟了那麼多,什麼事都沒有,還照樣跳舞唱歌。要是咱們呀,早得關店了。 </s></s> 這就是鐵飯碗的好處呀。</s>	joy	neutral
<s> 聽說是從窗戶鑽進去的,把保險櫃都給撬開了。 破案了嗎? 上哪兒破去?早跑沒影兒了。 他們辦公室存那麼多錢幹啥? 發工資。 你看,這邊發工資,小偷就來偷。小偷的消息咋那麼準呀?還不是有人給通消息?內外勾結! 他們應該有保險櫃嘛,還能自動報警呢。 有了內應,什麼事不能辦呀?以前說不定丟了多少呢,這一回丟大發了纔不得不報案的。 你看人家丟了那麼多,什麼事都沒有,還照樣跳舞唱歌。要是咱們呀,早得關店了。 這就是鐵飯碗的好處呀。 </s></s> “我們倆唱一首‘心雨’,希望大家喜歡。</s>	joy	joy
<s></s></s> 今天是國慶節,難得小馬到家裏來,咱們一塊喝一杯,祝全家節日快樂,乾杯!</s>	joy	joy
<s> 今天是國慶節,難得小馬到家裏來,咱們一塊喝一杯,祝全家節日快樂,乾杯! </s></s> 今天嫂子辛苦了,謝謝!</s>	joy	joy
<s></s></s> 小宋!</s>	surprise	neutral
<s> 小宋! </s></s> 王總!</s>	surprise	surprise
<s> 小宋! 王總! </s></s> 走,跟我上縣城!</s>	joy	surprise
<s></s></s> 咱們節前在縣裏和那個黃老闆訂了一個合同,買他二百噸鋼材,你還記得嗎?</s>	surprise	surprise
<s> 咱們節前在縣裏和那個黃老闆訂了一個合同,買他二百噸鋼材,你還記得嗎? </s></s> 咋不記得?咱們三個人,還有徐麗,咱們還上倉庫去看過貨。</s>	surprise	surprise
<s> 咱們節前在縣裏和那個黃老闆訂了一個合同,買他二百噸鋼材,你還記得嗎? 咋不記得?咱們三個人,還有徐麗,咱們還上倉庫去看過貨。 </s></s> 他說錢到了就發貨,可這都幾天了?國慶節都過了七天了,他的貨還沒來,打電話也沒人接,你說這叫啥事兒!</s>	surprise	angry
<s> 咱們節前在縣裏和那個黃老闆訂了一個合同,買他二百噸鋼材,你還記得嗎? 咋不記得?咱們三個人,還有徐麗,咱們還上倉庫去看過貨。 他說錢到了就發貨,可這都幾天了?國慶節都過了七天了,他的貨還沒來,打電話也沒人接,你說這叫啥事兒! </s></s> 不會是錢還沒到吧?</s>	surprise	surprise
<s> 咱們節前在縣裏和那個黃老闆訂了一個合同,買他二百噸鋼材,你還記得嗎? 咋不記得?咱們三個人,還有徐麗,咱們還上倉庫去看過貨。 他說錢到了就發貨,可這都幾天了?國慶節都過了七天了,他的貨還沒來,打電話也沒人接,你說這叫啥事兒! 不會是錢還沒到吧? </s></s> 不可能!就在一個縣城裏,跑腿送也送到了。</s>	surprise	angry
<s> 咱們節前在縣裏和那個黃老闆訂了一個合同,買他二百噸鋼材,你還記得嗎? 咋不記得?咱們三個人,還有徐麗,咱們還上倉庫去看過貨。 他說錢到了就發貨,可這都幾天了?國慶節都過了七天了,他的貨還沒來,打電話也沒人接,你說這叫啥事兒! 不會是錢還沒到吧? 不可能!就在一個縣城裏,跑腿送也送到了。 </s></s> 那是有問題。</s>	neutral	fear
<s> 咱們節前在縣裏和那個黃老闆訂了一個合同,買他二百噸鋼材,你還記得嗎? 咋不記得?咱們三個人,還有徐麗,咱們還上倉庫去看過貨。 他說錢到了就發貨,可這都幾天了?國慶節都過了七天了,他的貨還沒來,打電話也沒人接,你說這叫啥事兒! 不會是錢還沒到吧? 不可能!就在一個縣城裏,跑腿送也送到了。 那是有問題。 </s></s> 你說咱們是先看貨還是先找人?</s>	angry	fear
<s> 咱們節前在縣裏和那個黃老闆訂了一個合同,買他二百噸鋼材,你還記得嗎? 咋不記得?咱們三個人,還有徐麗,咱們還上倉庫去看過貨。 他說錢到了就發貨,可這都幾天了?國慶節都過了七天了,他的貨還沒來,打電話也沒人接,你說這叫啥事兒! 不會是錢還沒到吧? 不可能!就在一個縣城裏,跑腿送也送到了。 那是有問題。 你說咱們是先看貨還是先找人? </s></s> 還是應該先找人吧?</s>	neutral	surprise
<s></s></s> 請問,新亞工貿公司在哪裏?</s>	neutral	surprise
<s> 請問,新亞工貿公司在哪裏? </s></s> 這裏沒有新亞公司。</s>	neutral	neutral
<s> 請問,新亞工貿公司在哪裏? 這裏沒有新亞公司。 </s></s> 有什麼公司?</s>	surprise	surprise
<s> 請問,新亞工貿公司在哪裏? 這裏沒有新亞公司。 有什麼公司? </s></s> 啥公司也沒有,這是旅社,住人的。</s>	neutral	neutral
<s> 請問,新亞工貿公司在哪裏? 這裏沒有新亞公司。 有什麼公司? 啥公司也沒有,這是旅社,住人的。 </s></s> 他們是不是在這裏租房間辦公司呢?</s>	surprise	surprise
<s></s></s> 這附近有沒有叫新亞工貿公司的單位?</s>	surprise	fear
<s> 這附近有沒有叫新亞工貿公司的單位? </s></s> 那這裏是不是建設路98號呢?</s>	surprise	surprise
<s> 這附近有沒有叫新亞工貿公司的單位? 那這裏是不是建設路98號呢? </s></s> 你自己看嘛!</s>	neutral	disgust
<s></s></s> 怪了!明明是建設路98號嘛,怎麼說沒有這個公司呢?你常來縣城,這個建設路沒錯吧?你來過沒有?</s>	surprise	surprise
<s> 怪了!明明是建設路98號嘛,怎麼說沒有這個公司呢?你常來縣城,這個建設路沒錯吧?你來過沒有? </s></s> 我沒來過建設路,可是這條路是不會錯的。</s>	neutral	fear
<s> 怪了!明明是建設路98號嘛,怎麼說沒有這個公司呢?你常來縣城,這個建設路沒錯吧?你來過沒有? 我沒來過建設路,可是這條路是不會錯的。 </s></s> 奇怪!</s>	surprise	surprise
<s> 怪了!明明是建設路98號嘛,怎麼說沒有這個公司呢?你常來縣城,這個建設路沒錯吧?你來過沒有? 我沒來過建設路,可是這條路是不會錯的。 奇怪! </s></s> 你沒打電話嗎?</s>	surprise	surprise
<s> 怪了!明明是建設路98號嘛,怎麼說沒有這個公司呢?你常來縣城,這個建設路沒錯吧?你來過沒有? 我沒來過建設路,可是這條路是不會錯的。 奇怪! 你沒打電話嗎? </s></s> 打了,電話沒人接。</s>	neutral	fear
<s> 怪了!明明是建設路98號嘛,怎麼說沒有這個公司呢?你常來縣城,這個建設路沒錯吧?你來過沒有? 我沒來過建設路,可是這條路是不會錯的。 奇怪! 你沒打電話嗎? 打了,電話沒人接。 </s></s> 沒人接?還沒上班嗎?</s>	surprise	surprise
<s> 怪了!明明是建設路98號嘛,怎麼說沒有這個公司呢?你常來縣城,這個建設路沒錯吧?你來過沒有? 我沒來過建設路,可是這條路是不會錯的。 奇怪! 你沒打電話嗎? 打了,電話沒人接。 沒人接?還沒上班嗎? </s></s> 不可能!走,去看貨,上物資局倉庫!</s>	surprise	angry
<s></s></s> 請問黃老闆在哪裏?</s>	neutral	surprise
<s> 請問黃老闆在哪裏? </s></s> 哪一個黃老闆?</s>	surprise	surprise
<s> 請問黃老闆在哪裏? 哪一個黃老闆? </s></s> 新亞工貿公司的黃振東,黃總經理。</s>	neutral	neutral
<s> 請問黃老闆在哪裏? 哪一個黃老闆? 新亞工貿公司的黃振東,黃總經理。 </s></s> “不知道,不認識。”。</s>	surprise	disgust
<s> 請問黃老闆在哪裏? 哪一個黃老闆? 新亞工貿公司的黃振東,黃總經理。 “不知道,不認識。”。 </s></s> 不認識?他不是還有鋼材在你們庫裏代保管呢嗎?</s>	surprise	surprise
<s> 請問黃老闆在哪裏? 哪一個黃老闆? 新亞工貿公司的黃振東,黃總經理。 “不知道,不認識。”。 不認識?他不是還有鋼材在你們庫裏代保管呢嗎? </s></s> 鋼材?什麼鋼材?</s>	surprise	surprise
<s> 請問黃老闆在哪裏? 哪一個黃老闆? 新亞工貿公司的黃振東,黃總經理。 “不知道,不認識。”。 不認識?他不是還有鋼材在你們庫裏代保管呢嗎? 鋼材?什麼鋼材? </s></s> 盤條,一千多噸呢。</s>	surprise	surprise
<s></s></s> 我們自己的東西還管不過來呢,還給別人代管?</s>	angry	surprise
<s> 我們自己的東西還管不過來呢,還給別人代管? </s></s> 貨場那一大堆盤條,有一千來噸,是誰的?</s>	surprise	surprise
<s> 我們自己的東西還管不過來呢,還給別人代管? 貨場那一大堆盤條,有一千來噸,是誰的? </s></s> 我們的唄!在我們倉庫裏還能是誰的?</s>	joy	disgust
<s> 我們自己的東西還管不過來呢,還給別人代管? 貨場那一大堆盤條,有一千來噸,是誰的? 我們的唄!在我們倉庫裏還能是誰的? </s></s> 確實是你們的?不會是代別人保管的嗎?</s>	surprise	surprise
<s></s></s> 你誰呀?你是幹啥的?你哪個單位的?</s>	surprise	angry
<s> 你誰呀?你是幹啥的?你哪個單位的? </s></s> 我和這個公司定了一分合同,他賣給我們二百噸盤條。他帶我來看過貨,就是這堆盤條,總共一千噸,說是由你們代保管的。</s>	neutral	surprise
<s></s></s> 他胡扯蛋!他把這些盤條賣給你了?</s>	angry	angry
<s> 他胡扯蛋!他把這些盤條賣給你了? </s></s> 賣給我們二百噸。</s>	joy	neutral
<s> 他胡扯蛋!他把這些盤條賣給你了? 賣給我們二百噸。 </s></s> 他給你們發貨了嗎?</s>	surprise	surprise
<s> 他胡扯蛋!他把這些盤條賣給你了? 賣給我們二百噸。 他給你們發貨了嗎? </s></s> 他說收到錢就給我們發貨。</s>	neutral	neutral
<s> 他胡扯蛋!他把這些盤條賣給你了? 賣給我們二百噸。 他給你們發貨了嗎? 他說收到錢就給我們發貨。 </s></s> 你給他錢了嗎?</s>	angry	surprise
<s> 他胡扯蛋!他把這些盤條賣給你了? 賣給我們二百噸。 他給你們發貨了嗎? 他說收到錢就給我們發貨。 你給他錢了嗎? </s></s> 給了。</s>	neutral	neutral
<s> 他胡扯蛋!他把這些盤條賣給你了? 賣給我們二百噸。 他給你們發貨了嗎? 他說收到錢就給我們發貨。 你給他錢了嗎? 給了。 </s></s> 給了他多少錢?</s>	angry	surprise
<s> 他胡扯蛋!他把這些盤條賣給你了? 賣給我們二百噸。 他給你們發貨了嗎? 他說收到錢就給我們發貨。 你給他錢了嗎? 給了。 給了他多少錢? </s></s> 給了二百噸的錢,五十萬。</s>	angry	neutral
<s> 他胡扯蛋!他把這些盤條賣給你了? 賣給我們二百噸。 他給你們發貨了嗎? 他說收到錢就給我們發貨。 你給他錢了嗎? 給了。 給了他多少錢? 給了二百噸的錢,五十萬。 </s></s> 你上當了。這是個騙子!</s>	angry	surprise
<s></s></s> 你會不會搞錯,那要真是代保管的呢?</s>	surprise	fear
<s> 你會不會搞錯,那要真是代保管的呢? </s></s> 你纔會搞錯!</s>	angry	angry
<s> 你會不會搞錯,那要真是代保管的呢? 你纔會搞錯! </s></s> 你們倉庫領導在哪裏?</s>	surprise	angry
<s></s></s> 趕快上銀行!</s>	surprise	surprise
<s> 趕快上銀行! </s></s> 上哪個銀行?</s>	surprise	surprise
<s> 趕快上銀行! 上哪個銀行? </s></s> 城市信用社,也在建設路。</s>	neutral	fear
<s></s></s> 長脖兒!還在找你的孩子嗎?</s>	surprise	surprise
<s> 長脖兒!還在找你的孩子嗎? </s></s> 你看見了嗎?</s>	neutral	surprise
<s> 長脖兒!還在找你的孩子嗎? 你看見了嗎? </s></s> 看見了。</s>	neutral	neutral
<s> 長脖兒!還在找你的孩子嗎? 你看見了嗎? 看見了。 </s></s> 在哪兒?</s>	surprise	fear
<s></s></s> 那不是嗎?在那兒!他歪着腦袋在看你呢。</s>	surprise	joy
<s> 那不是嗎?在那兒!他歪着腦袋在看你呢。 </s></s> 你盡瞎扯!開玩笑!</s>	angry	angry
<s></s></s> 請問先生,這是出租車嗎?</s>	surprise	surprise
<s> 請問先生,這是出租車嗎? </s></s> 是的。</s>	neutral	neutral
<s> 請問先生,這是出租車嗎? 是的。 </s></s> 這位老先生想坐車在鎮上轉一圈,把所有的地方都看看,可以嗎?</s>	joy	surprise
<s> 請問先生,這是出租車嗎? 是的。 這位老先生想坐車在鎮上轉一圈,把所有的地方都看看,可以嗎? </s></s> 當然可以!請上車吧。</s>	joy	joy
<s></s></s> 你們是從日本來的,對嗎?</s>	surprise	joy
<s> 你們是從日本來的,對嗎? </s></s> 你怎麼知道?</s>	surprise	surprise
<s> 你們是從日本來的,對嗎? 你怎麼知道? </s></s> 一看就能看出來。你的漢語講得很好。</s>	joy	joy
<s></s></s> 小姐,我們可以走了嗎?</s>	neutral	joy
<s> 小姐,我們可以走了嗎? </s></s> 噢,可以,走吧。</s>	joy	joy
<s></s></s> 這裏住的是什麼人?</s>	surprise	surprise
<s> 這裏住的是什麼人? </s></s> 我不知道。</s>	neutral	neutral
<s> 這裏住的是什麼人? 我不知道。 </s></s> 這些房子是什麼時候蓋的呢?</s>	surprise	surprise
<s> 這裏住的是什麼人? 我不知道。 這些房子是什麼時候蓋的呢? </s></s> 我記事的時候就有,不知道啥時候蓋的。</s>	neutral	neutral
<s> 這裏住的是什麼人? 我不知道。 這些房子是什麼時候蓋的呢? 我記事的時候就有,不知道啥時候蓋的。 </s></s> 那麼四十年前這裏住的是什麼人?</s>	surprise	surprise
<s></s></s> 噢,那時候還沒有你呢吧?</s>	surprise	neutral
<s> 噢,那時候還沒有你呢吧? </s></s> 我可以幫忙打聽一下。</s>	neutral	neutral
<s> 噢,那時候還沒有你呢吧? 我可以幫忙打聽一下。 </s></s> 你跟誰打聽?</s>	surprise	surprise
<s> 噢,那時候還沒有你呢吧? 我可以幫忙打聽一下。 你跟誰打聽? </s></s> 我一個朋友的爺爺,他是老景陽鎮的人。</s>	neutral	joy
<s> 噢,那時候還沒有你呢吧? 我可以幫忙打聽一下。 你跟誰打聽? 我一個朋友的爺爺,他是老景陽鎮的人。 </s></s> 你朋友的爺爺?他姓什麼?</s>	surprise	surprise
<s> 噢,那時候還沒有你呢吧? 我可以幫忙打聽一下。 你跟誰打聽? 我一個朋友的爺爺,他是老景陽鎮的人。 你朋友的爺爺?他姓什麼? </s></s> 姓馬。</s>	neutral	neutral
<s> 噢,那時候還沒有你呢吧? 我可以幫忙打聽一下。 你跟誰打聽? 我一個朋友的爺爺,他是老景陽鎮的人。 你朋友的爺爺?他姓什麼? 姓馬。 </s></s> 叫馬什麼?</s>	surprise	surprise
<s> 噢,那時候還沒有你呢吧? 我可以幫忙打聽一下。 你跟誰打聽? 我一個朋友的爺爺,他是老景陽鎮的人。 你朋友的爺爺?他姓什麼? 姓馬。 叫馬什麼? </s></s> 叫馬洪偉。</s>	neutral	neutral
<s></s></s> 有七十多歲了,都離休十來年了。</s>	sadness	neutral
<s> 有七十多歲了,都離休十來年了。 </s></s> 離休?</s>	surprise	surprise
<s> 有七十多歲了,都離休十來年了。 離休? </s></s> 他以前是景陽鎮木材加工廠的廠長,後來是林業局黨委書記,老革命。</s>	neutral	neutral
<s> 有七十多歲了,都離休十來年了。 離休? 他以前是景陽鎮木材加工廠的廠長,後來是林業局黨委書記,老革命。 </s></s> 加工廠廠長?馬洪偉?他在哪兒?</s>	surprise	surprise
<s> 有七十多歲了,都離休十來年了。 離休? 他以前是景陽鎮木材加工廠的廠長,後來是林業局黨委書記,老革命。 加工廠廠長?馬洪偉?他在哪兒? </s></s> 他就在景陽鎮。</s>	neutral	neutral
<s> 有七十多歲了,都離休十來年了。 離休? 他以前是景陽鎮木材加工廠的廠長,後來是林業局黨委書記,老革命。 加工廠廠長?馬洪偉?他在哪兒? 他就在景陽鎮。 </s></s> 還在景陽鎮?我能不能見他一面呢?</s>	surprise	surprise
<s> 有七十多歲了,都離休十來年了。 離休? 他以前是景陽鎮木材加工廠的廠長,後來是林業局黨委書記,老革命。 加工廠廠長?馬洪偉?他在哪兒? 他就在景陽鎮。 還在景陽鎮?我能不能見他一面呢? </s></s> 當然能。</s>	joy	joy
<s> 有七十多歲了,都離休十來年了。 離休? 他以前是景陽鎮木材加工廠的廠長,後來是林業局黨委書記,老革命。 加工廠廠長?馬洪偉?他在哪兒? 他就在景陽鎮。 還在景陽鎮?我能不能見他一面呢? 當然能。 </s></s> 鎮上的官員能找到他嗎?</s>	surprise	surprise
<s> 有七十多歲了,都離休十來年了。 離休? 他以前是景陽鎮木材加工廠的廠長,後來是林業局黨委書記,老革命。 加工廠廠長?馬洪偉?他在哪兒? 他就在景陽鎮。 還在景陽鎮?我能不能見他一面呢? 當然能。 鎮上的官員能找到他嗎? </s></s> 當然能。</s>	neutral	joy
<s> 有七十多歲了,都離休十來年了。 離休? 他以前是景陽鎮木材加工廠的廠長,後來是林業局黨委書記,老革命。 加工廠廠長?馬洪偉?他在哪兒? 他就在景陽鎮。 還在景陽鎮?我能不能見他一面呢? 當然能。 鎮上的官員能找到他嗎? 當然能。 </s></s> 哦,太好了!太好了!</s>	joy	joy
<s> 有七十多歲了,都離休十來年了。 離休? 他以前是景陽鎮木材加工廠的廠長,後來是林業局黨委書記,老革命。 加工廠廠長?馬洪偉?他在哪兒? 他就在景陽鎮。 還在景陽鎮?我能不能見他一面呢? 當然能。 鎮上的官員能找到他嗎? 當然能。 哦,太好了!太好了! </s></s> 咱們再上螞蟻河去看看吧?</s>	joy	joy
<s> 離休? 他以前是景陽鎮木材加工廠的廠長,後來是林業局黨委書記,老革命。 加工廠廠長?馬洪偉?他在哪兒? 他就在景陽鎮。 還在景陽鎮?我能不能見他一面呢? 當然能。 鎮上的官員能找到他嗎? 當然能。 哦,太好了!太好了! 咱們再上螞蟻河去看看吧? </s></s> 好啊,走吧。</s>	joy	joy
<s></s></s> 這螞蟻河是景陽鎮的一景,外面來的人都要上來看看。</s>	joy	joy
<s> 這螞蟻河是景陽鎮的一景,外面來的人都要上來看看。 </s></s> 好啊,我也正想來看看呢。</s>	joy	joy
<s></s></s> 變啦!真是大變啦!和那時候完全不一樣啦!那時候螞蟻河有兩座橋,這裏是頭道橋,前邊是二道橋,橋都很小。不過那時候水比現在大。我們常在橋下游泳。水挺深,能沒人。大概是在臨解放的時候,國民黨從這裏撤退。他們乾的最後一件事是把兩個火車頭開到橋上來,然後點火燒橋,用這個辦法來報復解放軍。那時候橋是木頭的。着火的時候許多人站在河邊看,乾瞪眼沒辦法。結果大橋燒塌了,兩個火車頭翻到河裏,在水裏泡了好長時間。我們游泳的時候還爬到火車頭上去玩。後來政府從旁邊臨時修了一段路,鋪上鐵軌,把火車頭從河裏拖上來。這都多少年了?有四十年啦!</s>	joy	surprise
<s> 變啦!真是大變啦!和那時候完全不一樣啦!那時候螞蟻河有兩座橋,這裏是頭道橋,前邊是二道橋,橋都很小。不過那時候水比現在大。我們常在橋下游泳。水挺深,能沒人。大概是在臨解放的時候,國民黨從這裏撤退。他們乾的最後一件事是把兩個火車頭開到橋上來,然後點火燒橋,用這個辦法來報復解放軍。那時候橋是木頭的。着火的時候許多人站在河邊看,乾瞪眼沒辦法。結果大橋燒塌了,兩個火車頭翻到河裏,在水裏泡了好長時間。我們游泳的時候還爬到火車頭上去玩。後來政府從旁邊臨時修了一段路,鋪上鐵軌,把火車頭從河裏拖上來。這都多少年了?有四十年啦! </s></s> 那時候螞蟻河就是景陽鎮的邊緣了,河北邊根本沒有人住,一片大草甸子,現在全是房子了。</s>	neutral	surprise
<s> 變啦!真是大變啦!和那時候完全不一樣啦!那時候螞蟻河有兩座橋,這裏是頭道橋,前邊是二道橋,橋都很小。不過那時候水比現在大。我們常在橋下游泳。水挺深,能沒人。大概是在臨解放的時候,國民黨從這裏撤退。他們乾的最後一件事是把兩個火車頭開到橋上來,然後點火燒橋,用這個辦法來報復解放軍。那時候橋是木頭的。着火的時候許多人站在河邊看,乾瞪眼沒辦法。結果大橋燒塌了,兩個火車頭翻到河裏,在水裏泡了好長時間。我們游泳的時候還爬到火車頭上去玩。後來政府從旁邊臨時修了一段路,鋪上鐵軌,把火車頭從河裏拖上來。這都多少年了?有四十年啦! 那時候螞蟻河就是景陽鎮的邊緣了,河北邊根本沒有人住,一片大草甸子,現在全是房子了。 </s></s> 高麗屯是在那邊吧?</s>	neutral	surprise
<s> 變啦!真是大變啦!和那時候完全不一樣啦!那時候螞蟻河有兩座橋,這裏是頭道橋,前邊是二道橋,橋都很小。不過那時候水比現在大。我們常在橋下游泳。水挺深,能沒人。大概是在臨解放的時候,國民黨從這裏撤退。他們乾的最後一件事是把兩個火車頭開到橋上來,然後點火燒橋,用這個辦法來報復解放軍。那時候橋是木頭的。着火的時候許多人站在河邊看,乾瞪眼沒辦法。結果大橋燒塌了,兩個火車頭翻到河裏,在水裏泡了好長時間。我們游泳的時候還爬到火車頭上去玩。後來政府從旁邊臨時修了一段路,鋪上鐵軌,把火車頭從河裏拖上來。這都多少年了?有四十年啦! 那時候螞蟻河就是景陽鎮的邊緣了,河北邊根本沒有人住,一片大草甸子,現在全是房子了。 高麗屯是在那邊吧? </s></s> 是的,不遠。</s>	neutral	joy
<s> 變啦!真是大變啦!和那時候完全不一樣啦!那時候螞蟻河有兩座橋,這裏是頭道橋,前邊是二道橋,橋都很小。不過那時候水比現在大。我們常在橋下游泳。水挺深,能沒人。大概是在臨解放的時候,國民黨從這裏撤退。他們乾的最後一件事是把兩個火車頭開到橋上來,然後點火燒橋,用這個辦法來報復解放軍。那時候橋是木頭的。着火的時候許多人站在河邊看,乾瞪眼沒辦法。結果大橋燒塌了,兩個火車頭翻到河裏,在水裏泡了好長時間。我們游泳的時候還爬到火車頭上去玩。後來政府從旁邊臨時修了一段路,鋪上鐵軌,把火車頭從河裏拖上來。這都多少年了?有四十年啦! 那時候螞蟻河就是景陽鎮的邊緣了,河北邊根本沒有人住,一片大草甸子,現在全是房子了。 高麗屯是在那邊吧? 是的,不遠。 </s></s> 那時候可覺得挺遠呢,中間隔着挺大一片草地。</s>	neutral	joy
<s></s></s> 這裏過去是鐵路,通到山裏,前邊還有個火車站。</s>	neutral	joy
<s> 這裏過去是鐵路,通到山裏,前邊還有個火車站。 </s></s> 現在的鐵路在那邊,是小火車,也是通山裏的。</s>	neutral	joy
<s></s></s> 那邊有個水泡子,叫東大泡子,我們常去釣魚,很遠,小孩子們都不願去。</s>	neutral	joy
<s> 那邊有個水泡子,叫東大泡子,我們常去釣魚,很遠,小孩子們都不願去。 </s></s> 這裏也有一個泡子,比較小,也不遠,過了二道橋就是。我們常在這裏釣魚。釣上來的魚都不大,鱗是紅色的。我們管它叫老頭魚。現在這些泡子都沒有了,都給填平蓋房子了。</s>	neutral	joy
<s> 那邊有個水泡子,叫東大泡子,我們常去釣魚,很遠,小孩子們都不願去。 這裏也有一個泡子,比較小,也不遠,過了二道橋就是。我們常在這裏釣魚。釣上來的魚都不大,鱗是紅色的。我們管它叫老頭魚。現在這些泡子都沒有了,都給填平蓋房子了。 </s></s> 爸爸,咱們回去吧,這橋上風太大。</s>	fear	fear
<s></s></s> 是的。</s>	neutral	neutral
<s> 是的。 </s></s> 以前那裏住的都是朝鮮人,那個大壩也是朝鮮人壘起來的,所以才叫高麗壩。我離開景陽鎮的時候也在那裏住。</s>	neutral	joy
<s> 是的。 以前那裏住的都是朝鮮人,那個大壩也是朝鮮人壘起來的,所以才叫高麗壩。我離開景陽鎮的時候也在那裏住。 </s></s> 您剛纔是想找當年您住的房子嗎?</s>	neutral	surprise
<s> 是的。 以前那裏住的都是朝鮮人,那個大壩也是朝鮮人壘起來的,所以才叫高麗壩。我離開景陽鎮的時候也在那裏住。 您剛纔是想找當年您住的房子嗎? </s></s> 是呀,找不到啦,全變啦,老房子都沒啦。</s>	neutral	sadness
<s> 是的。 以前那裏住的都是朝鮮人,那個大壩也是朝鮮人壘起來的,所以才叫高麗壩。我離開景陽鎮的時候也在那裏住。 您剛纔是想找當年您住的房子嗎? 是呀,找不到啦,全變啦,老房子都沒啦。 </s></s> 現在朝鮮人都住在高麗屯。</s>	neutral	neutral
<s> 是的。 以前那裏住的都是朝鮮人,那個大壩也是朝鮮人壘起來的,所以才叫高麗壩。我離開景陽鎮的時候也在那裏住。 您剛纔是想找當年您住的房子嗎? 是呀,找不到啦,全變啦,老房子都沒啦。 現在朝鮮人都住在高麗屯。 </s></s> 那時候好像還沒有高麗屯,只有高麗壩。</s>	neutral	neutral
<s> 是的。 以前那裏住的都是朝鮮人,那個大壩也是朝鮮人壘起來的,所以才叫高麗壩。我離開景陽鎮的時候也在那裏住。 您剛纔是想找當年您住的房子嗎? 是呀,找不到啦,全變啦,老房子都沒啦。 現在朝鮮人都住在高麗屯。 那時候好像還沒有高麗屯,只有高麗壩。 </s></s> 等找到老人問一問就知道了,咱們現在先回去吧。</s>	neutral	joy
<s></s></s> 這個電話,3677438,是這個旅社的嗎?</s>	surprise	surprise
<s> 這個電話,3677438,是這個旅社的嗎? </s></s> 是三樓的。</s>	neutral	neutral
<s></s></s> 這個電話號碼是多少?</s>	surprise	surprise
<s> 這個電話號碼是多少? </s></s> 3677438。</s>	neutral	neutral
<s> 這個電話號碼是多少? 3677438。 </s></s> 國慶節前有沒有一個姓黃的人在這裏住過?</s>	neutral	surprise
<s> 這個電話號碼是多少? 3677438。 國慶節前有沒有一個姓黃的人在這裏住過? </s></s> 國慶節前幾天就沒人住了,有沒有姓黃的得到總檯查登記冊。</s>	neutral	neutral
<s></s></s> 我想看看國慶節前後的旅客登記冊,可以嗎?</s>	neutral	fear
<s> 我想看看國慶節前後的旅客登記冊,可以嗎? </s></s> 你要查什麼?</s>	surprise	surprise
<s> 我想看看國慶節前後的旅客登記冊,可以嗎? 你要查什麼? </s></s> “我想看看國慶節前後有沒有一個姓黃的人在這住過過“</s>	neutral	fear
<s></s></s> 你自己看吧。</s>	neutral	neutral
<s> 你自己看吧。 </s></s> 登記冊就這一本,再沒有了嗎?</s>	surprise	disgust
<s> 你自己看吧。 登記冊就這一本,再沒有了嗎? </s></s> 沒了。</s>	neutral	neutral
<s></s></s> 你在這等一下,我去找個人。</s>	neutral	neutral
<s> 你在這等一下,我去找個人。 </s></s> 好的。</s>	neutral	neutral
<s></s></s> 請問小吳在嗎?</s>	neutral	surprise
<s> 請問小吳在嗎? </s></s> 哪個小吳?</s>	neutral	surprise
<s> 請問小吳在嗎? 哪個小吳? </s></s> 她叫吳——吳什麼?是23號!</s>	surprise	surprise
<s> 請問小吳在嗎? 哪個小吳? 她叫吳——吳什麼?是23號! </s></s> 吳春梅?</s>	surprise	surprise
<s> 請問小吳在嗎? 哪個小吳? 她叫吳——吳什麼?是23號! 吳春梅? </s></s> 對,吳春梅。</s>	neutral	surprise
<s> 請問小吳在嗎? 哪個小吳? 她叫吳——吳什麼?是23號! 吳春梅? 對,吳春梅。 </s></s> 請等一下。</s>	neutral	neutral
<s></s></s> 我真的不知道。他其實也就來過一兩次,那次正好叫你碰上了。</s>	neutral	fear
<s> 我真的不知道。他其實也就來過一兩次,那次正好叫你碰上了。 </s></s> 來一次就讓我碰上了,怎麼那麼巧?</s>	surprise	angry
<s> 我真的不知道。他其實也就來過一兩次,那次正好叫你碰上了。 來一次就讓我碰上了,怎麼那麼巧? </s></s> 那我咋知道?你們有緣唄。</s>	joy	disgust
<s> 我真的不知道。他其實也就來過一兩次,那次正好叫你碰上了。 來一次就讓我碰上了,怎麼那麼巧? 那我咋知道?你們有緣唄。 </s></s> 算我倒黴,碰上了他!如果姓黃的再來,你立刻就給我打電話,有他的消息你也告訴我,聽見了嗎?</s>	joy	angry
<s> 我真的不知道。他其實也就來過一兩次,那次正好叫你碰上了。 來一次就讓我碰上了,怎麼那麼巧? 那我咋知道?你們有緣唄。 算我倒黴,碰上了他!如果姓黃的再來,你立刻就給我打電話,有他的消息你也告訴我,聽見了嗎? </s></s> 知道。</s>	joy	neutral
<s> 我真的不知道。他其實也就來過一兩次,那次正好叫你碰上了。 來一次就讓我碰上了,怎麼那麼巧? 那我咋知道?你們有緣唄。 算我倒黴,碰上了他!如果姓黃的再來,你立刻就給我打電話,有他的消息你也告訴我,聽見了嗎? 知道。 </s></s> 你回去吧。</s>	neutral	disgust
<s></s></s> 還上哪兒?</s>	surprise	surprise
<s> 還上哪兒? </s></s> 上公安局!報案!</s>	angry	angry
<s></s></s> 鎮長,有位外賓要見您。</s>	neutral	neutral
<s> 鎮長,有位外賓要見您。 </s></s> 外賓?從哪兒來的?</s>	surprise	surprise
<s> 鎮長,有位外賓要見您。 外賓?從哪兒來的? </s></s> 說是從韓國來的,一個女孩子。</s>	joy	neutral
<s> 鎮長,有位外賓要見您。 外賓?從哪兒來的? 說是從韓國來的,一個女孩子。 </s></s> 請她進來。</s>	neutral	neutral
<s> 鎮長,有位外賓要見您。 外賓?從哪兒來的? 說是從韓國來的,一個女孩子。 請她進來。 </s></s> 進來吧。</s>	neutral	neutral
<s></s></s> 你給老書記打個電話,說有外賓要見他,讓他到賓館208號房間去一趟。</s>	neutral	neutral
<s> 你給老書記打個電話,說有外賓要見他,讓他到賓館208號房間去一趟。 </s></s> 好的。</s>	neutral	neutral
<s> 你給老書記打個電話,說有外賓要見他,讓他到賓館208號房間去一趟。 好的。 </s></s> 電話號你知道嗎?</s>	surprise	surprise
<s> 你給老書記打個電話,說有外賓要見他,讓他到賓館208號房間去一趟。 好的。 電話號你知道嗎? </s></s> 知道。</s>	neutral	neutral
<s> 你給老書記打個電話,說有外賓要見他,讓他到賓館208號房間去一趟。 好的。 電話號你知道嗎? 知道。 </s></s> 你去吧。</s>	neutral	neutral
<s></s></s> 王總!</s>	angry	surprise
<s> 王總! </s></s> 麗麗!快進來。</s>	joy	surprise
<s></s></s> 小齊,王總說,讓咱倆去調查一下印刷廠買印刷機的事兒。</s>	neutral	neutral
<s> 小齊,王總說,讓咱倆去調查一下印刷廠買印刷機的事兒。 </s></s> 調查買印刷機的事兒?</s>	surprise	surprise
<s> 小齊,王總說,讓咱倆去調查一下印刷廠買印刷機的事兒。 調查買印刷機的事兒? </s></s> 是呀。</s>	neutral	neutral
<s> 小齊,王總說,讓咱倆去調查一下印刷廠買印刷機的事兒。 調查買印刷機的事兒? 是呀。 </s></s> 印刷機有問題了?</s>	surprise	surprise
<s> 小齊,王總說,讓咱倆去調查一下印刷廠買印刷機的事兒。 調查買印刷機的事兒? 是呀。 印刷機有問題了? </s></s> 肯定有問題!你想呀,咱們自己本來就有印刷機,可是放着不用非要去買新的,結果買來了兩臺印刷機一臺都不能用,最後還得上哈爾濱去印報紙,你說這不是問題嗎?</s>	surprise	disgust
<s> 小齊,王總說,讓咱倆去調查一下印刷廠買印刷機的事兒。 調查買印刷機的事兒? 是呀。 印刷機有問題了? 肯定有問題!你想呀,咱們自己本來就有印刷機,可是放着不用非要去買新的,結果買來了兩臺印刷機一臺都不能用,最後還得上哈爾濱去印報紙,你說這不是問題嗎? </s></s> 是有問題,肯定機器的質量有問題。</s>	fear	disgust
<s> 小齊,王總說,讓咱倆去調查一下印刷廠買印刷機的事兒。 調查買印刷機的事兒? 是呀。 印刷機有問題了? 肯定有問題!你想呀,咱們自己本來就有印刷機,可是放着不用非要去買新的,結果買來了兩臺印刷機一臺都不能用,最後還得上哈爾濱去印報紙,你說這不是問題嗎? 是有問題,肯定機器的質量有問題。 </s></s> 不光是機器的質量問題。哈爾濱來的技師說,他們買的這機器都是淘汰貨,根本不能用!</s>	angry	angry
<s> 小齊,王總說,讓咱倆去調查一下印刷廠買印刷機的事兒。 調查買印刷機的事兒? 是呀。 印刷機有問題了? 肯定有問題!你想呀,咱們自己本來就有印刷機,可是放着不用非要去買新的,結果買來了兩臺印刷機一臺都不能用,最後還得上哈爾濱去印報紙,你說這不是問題嗎? 是有問題,肯定機器的質量有問題。 不光是機器的質量問題。哈爾濱來的技師說,他們買的這機器都是淘汰貨,根本不能用! </s></s> 那可就嚴重了。</s>	fear	fear
<s> 小齊,王總說,讓咱倆去調查一下印刷廠買印刷機的事兒。 調查買印刷機的事兒? 是呀。 印刷機有問題了? 肯定有問題!你想呀,咱們自己本來就有印刷機,可是放着不用非要去買新的,結果買來了兩臺印刷機一臺都不能用,最後還得上哈爾濱去印報紙,你說這不是問題嗎? 是有問題,肯定機器的質量有問題。 不光是機器的質量問題。哈爾濱來的技師說,他們買的這機器都是淘汰貨,根本不能用! 那可就嚴重了。 </s></s> 是呀,所以王總讓咱們去調查一下,這裏說不定有啥貓兒匿呢!</s>	neutral	fear
<s> 小齊,王總說,讓咱倆去調查一下印刷廠買印刷機的事兒。 調查買印刷機的事兒? 是呀。 印刷機有問題了? 肯定有問題!你想呀,咱們自己本來就有印刷機,可是放着不用非要去買新的,結果買來了兩臺印刷機一臺都不能用,最後還得上哈爾濱去印報紙,你說這不是問題嗎? 是有問題,肯定機器的質量有問題。 不光是機器的質量問題。哈爾濱來的技師說,他們買的這機器都是淘汰貨,根本不能用! 那可就嚴重了。 是呀,所以王總讓咱們去調查一下,這裏說不定有啥貓兒匿呢! </s></s> 那得上哪兒去調查呀?</s>	surprise	surprise
<s> 小齊,王總說,讓咱倆去調查一下印刷廠買印刷機的事兒。 調查買印刷機的事兒? 是呀。 印刷機有問題了? 肯定有問題!你想呀,咱們自己本來就有印刷機,可是放着不用非要去買新的,結果買來了兩臺印刷機一臺都不能用,最後還得上哈爾濱去印報紙,你說這不是問題嗎? 是有問題,肯定機器的質量有問題。 不光是機器的質量問題。哈爾濱來的技師說,他們買的這機器都是淘汰貨,根本不能用! 那可就嚴重了。 是呀,所以王總讓咱們去調查一下,這裏說不定有啥貓兒匿呢! 那得上哪兒去調查呀? </s></s> 上哈爾濱,賣印刷機的那個廠!</s>	angry	neutral
<s> 調查買印刷機的事兒? 是呀。 印刷機有問題了? 肯定有問題!你想呀,咱們自己本來就有印刷機,可是放着不用非要去買新的,結果買來了兩臺印刷機一臺都不能用,最後還得上哈爾濱去印報紙,你說這不是問題嗎? 是有問題,肯定機器的質量有問題。 不光是機器的質量問題。哈爾濱來的技師說,他們買的這機器都是淘汰貨,根本不能用! 那可就嚴重了。 是呀,所以王總讓咱們去調查一下,這裏說不定有啥貓兒匿呢! 那得上哪兒去調查呀? 上哈爾濱,賣印刷機的那個廠! </s></s> 你知道是哪個廠嗎?</s>	surprise	surprise
<s> 是呀。 印刷機有問題了? 肯定有問題!你想呀,咱們自己本來就有印刷機,可是放着不用非要去買新的,結果買來了兩臺印刷機一臺都不能用,最後還得上哈爾濱去印報紙,你說這不是問題嗎? 是有問題,肯定機器的質量有問題。 不光是機器的質量問題。哈爾濱來的技師說,他們買的這機器都是淘汰貨,根本不能用! 那可就嚴重了。 是呀,所以王總讓咱們去調查一下,這裏說不定有啥貓兒匿呢! 那得上哪兒去調查呀? 上哈爾濱,賣印刷機的那個廠! 你知道是哪個廠嗎? </s></s> 上財務科一問不就知道了!</s>	neutral	joy
<s> 印刷機有問題了? 肯定有問題!你想呀,咱們自己本來就有印刷機,可是放着不用非要去買新的,結果買來了兩臺印刷機一臺都不能用,最後還得上哈爾濱去印報紙,你說這不是問題嗎? 是有問題,肯定機器的質量有問題。 不光是機器的質量問題。哈爾濱來的技師說,他們買的這機器都是淘汰貨,根本不能用! 那可就嚴重了。 是呀,所以王總讓咱們去調查一下,這裏說不定有啥貓兒匿呢! 那得上哪兒去調查呀? 上哈爾濱,賣印刷機的那個廠! 你知道是哪個廠嗎? 上財務科一問不就知道了! </s></s> 人家能跟咱們說嗎?咱們憑啥管人家的事兒呀?</s>	angry	fear
<s> 肯定有問題!你想呀,咱們自己本來就有印刷機,可是放着不用非要去買新的,結果買來了兩臺印刷機一臺都不能用,最後還得上哈爾濱去印報紙,你說這不是問題嗎? 是有問題,肯定機器的質量有問題。 不光是機器的質量問題。哈爾濱來的技師說,他們買的這機器都是淘汰貨,根本不能用! 那可就嚴重了。 是呀,所以王總讓咱們去調查一下,這裏說不定有啥貓兒匿呢! 那得上哪兒去調查呀? 上哈爾濱,賣印刷機的那個廠! 你知道是哪個廠嗎? 上財務科一問不就知道了! 人家能跟咱們說嗎?咱們憑啥管人家的事兒呀? </s></s> 對,不能上財務科,問問小蘭就行,她會告訴我的。明天是星期天,我上青河她家裏去找她。</s>	neutral	neutral
<s> 是有問題,肯定機器的質量有問題。 不光是機器的質量問題。哈爾濱來的技師說,他們買的這機器都是淘汰貨,根本不能用! 那可就嚴重了。 是呀,所以王總讓咱們去調查一下,這裏說不定有啥貓兒匿呢! 那得上哪兒去調查呀? 上哈爾濱,賣印刷機的那個廠! 你知道是哪個廠嗎? 上財務科一問不就知道了! 人家能跟咱們說嗎?咱們憑啥管人家的事兒呀? 對,不能上財務科,問問小蘭就行,她會告訴我的。明天是星期天,我上青河她家裏去找她。 </s></s> 要我跟你一塊去嗎?</s>	joy	surprise
<s> 不光是機器的質量問題。哈爾濱來的技師說,他們買的這機器都是淘汰貨,根本不能用! 那可就嚴重了。 是呀,所以王總讓咱們去調查一下,這裏說不定有啥貓兒匿呢! 那得上哪兒去調查呀? 上哈爾濱,賣印刷機的那個廠! 你知道是哪個廠嗎? 上財務科一問不就知道了! 人家能跟咱們說嗎?咱們憑啥管人家的事兒呀? 對,不能上財務科,問問小蘭就行,她會告訴我的。明天是星期天,我上青河她家裏去找她。 要我跟你一塊去嗎? </s></s> 不用,人多了也不好。</s>	neutral	neutral
<s></s></s> 來吧。</s>	neutral	joy
<s> 來吧。 </s></s> 盛哥,我不進去了,你讓小蘭出來吧。</s>	neutral	neutral
<s> 來吧。 盛哥,我不進去了,你讓小蘭出來吧。 </s></s> 行,那你等着,我去叫她。</s>	neutral	joy
<s></s></s> 麗麗!你咋來了?咋不進屋?</s>	surprise	surprise
<s> 麗麗!你咋來了?咋不進屋? </s></s> 小蘭姐!我找你有點事兒。</s>	neutral	joy
<s> 麗麗!你咋來了?咋不進屋? 小蘭姐!我找你有點事兒。 </s></s> 那就進屋說唄。</s>	joy	joy
<s> 麗麗!你咋來了?咋不進屋? 小蘭姐!我找你有點事兒。 那就進屋說唄。 </s></s> 不了。小蘭姐,是這樣,我想跟你說點事兒,正好盛哥該回來吃飯,我就跟他的車過來了。</s>	neutral	joy
<s> 麗麗!你咋來了?咋不進屋? 小蘭姐!我找你有點事兒。 那就進屋說唄。 不了。小蘭姐,是這樣,我想跟你說點事兒,正好盛哥該回來吃飯,我就跟他的車過來了。 </s></s> 正好在這吃飯唄!</s>	joy	joy
<s> 麗麗!你咋來了?咋不進屋? 小蘭姐!我找你有點事兒。 那就進屋說唄。 不了。小蘭姐,是這樣,我想跟你說點事兒,正好盛哥該回來吃飯,我就跟他的車過來了。 正好在這吃飯唄! </s></s> 不行!不方便,我也不願意在人家家裏吃飯。這裏不是有飯館嗎?我願意下飯館,你陪我下趟館子吧。咱倆一塊在飯館吃飯,吃完飯我還想跟你哥的車回去呢!</s>	disgust	joy
<s> 麗麗!你咋來了?咋不進屋? 小蘭姐!我找你有點事兒。 那就進屋說唄。 不了。小蘭姐,是這樣,我想跟你說點事兒,正好盛哥該回來吃飯,我就跟他的車過來了。 正好在這吃飯唄! 不行!不方便,我也不願意在人家家裏吃飯。這裏不是有飯館嗎?我願意下飯館,你陪我下趟館子吧。咱倆一塊在飯館吃飯,吃完飯我還想跟你哥的車回去呢! </s></s> 好!我跟我媽說一聲。</s>	joy	joy
<s></s></s> 漂亮小姐請吃飯,這是多好的事呀,我咋能不來呢?</s>	joy	joy
<s> 漂亮小姐請吃飯,這是多好的事呀,我咋能不來呢? </s></s> 你說這人多討厭,他非得跟着去!</s>	angry	disgust
<s> 漂亮小姐請吃飯,這是多好的事呀,我咋能不來呢? 你說這人多討厭,他非得跟着去! </s></s> 好啊,一塊吧,人多了熱鬧。</s>	joy	joy
<s> 漂亮小姐請吃飯,這是多好的事呀,我咋能不來呢? 你說這人多討厭,他非得跟着去! 好啊,一塊吧,人多了熱鬧。 </s></s> 對嘛!她請我吃飯,我免費請她坐車,咱們兩清了!</s>	joy	joy
<s> 漂亮小姐請吃飯,這是多好的事呀,我咋能不來呢? 你說這人多討厭,他非得跟着去! 好啊,一塊吧,人多了熱鬧。 對嘛!她請我吃飯,我免費請她坐車,咱們兩清了! </s></s> 好吧,咱們走!</s>	joy	joy
<s></s></s> 節前馬軍從我們這裏借了一百萬,買印刷機,到現在還沒來報帳呢,聽說機器已經買來了?</s>	surprise	surprise
<s> 節前馬軍從我們這裏借了一百萬,買印刷機,到現在還沒來報帳呢,聽說機器已經買來了? </s></s> 機器在節前就來了,安裝的時候發現有問題,回去換了一次配件,還不行,又把機器退了。這次換來的機器還沒用呢,不知道行不行。</s>	fear	sadness
<s> 節前馬軍從我們這裏借了一百萬,買印刷機,到現在還沒來報帳呢,聽說機器已經買來了? 機器在節前就來了,安裝的時候發現有問題,回去換了一次配件,還不行,又把機器退了。這次換來的機器還沒用呢,不知道行不行。 </s></s> “報紙不是都出了嗎?</s>	surprise	surprise
<s></s></s> 那是在哈爾濱,在人家的印刷廠印的。咱們現把清樣拿過去的。</s>	joy	neutral
<s> 那是在哈爾濱,在人家的印刷廠印的。咱們現把清樣拿過去的。 </s></s> 這事是誰幹的?馬軍吧?那個花花公子他能幹啥?</s>	surprise	angry
<s> 那是在哈爾濱,在人家的印刷廠印的。咱們現把清樣拿過去的。 這事是誰幹的?馬軍吧?那個花花公子他能幹啥? </s></s> 你知道那臺機器是從哪兒買來的嗎?</s>	surprise	surprise
<s> 那是在哈爾濱,在人家的印刷廠印的。咱們現把清樣拿過去的。 這事是誰幹的?馬軍吧?那個花花公子他能幹啥? 你知道那臺機器是從哪兒買來的嗎? </s></s> 哈爾濱,哈爾濱印刷器材公司,錢是匯給他們的,機器肯定就是他們的。</s>	joy	neutral
<s> 那是在哈爾濱,在人家的印刷廠印的。咱們現把清樣拿過去的。 這事是誰幹的?馬軍吧?那個花花公子他能幹啥? 你知道那臺機器是從哪兒買來的嗎? 哈爾濱,哈爾濱印刷器材公司,錢是匯給他們的,機器肯定就是他們的。 </s></s> 哈爾濱印刷器材公司?這個單位在啥地方?</s>	surprise	surprise
<s> 那是在哈爾濱,在人家的印刷廠印的。咱們現把清樣拿過去的。 這事是誰幹的?馬軍吧?那個花花公子他能幹啥? 你知道那臺機器是從哪兒買來的嗎? 哈爾濱,哈爾濱印刷器材公司,錢是匯給他們的,機器肯定就是他們的。 哈爾濱印刷器材公司?這個單位在啥地方? </s></s> 在哈爾濱唄,具體是哪兒不知道,發票上可能有地址。</s>	neutral	neutral
<s> 那是在哈爾濱,在人家的印刷廠印的。咱們現把清樣拿過去的。 這事是誰幹的?馬軍吧?那個花花公子他能幹啥? 你知道那臺機器是從哪兒買來的嗎? 哈爾濱,哈爾濱印刷器材公司,錢是匯給他們的,機器肯定就是他們的。 哈爾濱印刷器材公司?這個單位在啥地方? 在哈爾濱唄,具體是哪兒不知道,發票上可能有地址。 </s></s> 你能把發票拿給我看看嗎?</s>	surprise	surprise
<s> 那是在哈爾濱,在人家的印刷廠印的。咱們現把清樣拿過去的。 這事是誰幹的?馬軍吧?那個花花公子他能幹啥? 你知道那臺機器是從哪兒買來的嗎? 哈爾濱,哈爾濱印刷器材公司,錢是匯給他們的,機器肯定就是他們的。 哈爾濱印刷器材公司?這個單位在啥地方? 在哈爾濱唄,具體是哪兒不知道,發票上可能有地址。 你能把發票拿給我看看嗎? </s></s> 你看發票幹啥?要找他們?</s>	surprise	surprise
<s> 那是在哈爾濱,在人家的印刷廠印的。咱們現把清樣拿過去的。 這事是誰幹的?馬軍吧?那個花花公子他能幹啥? 你知道那臺機器是從哪兒買來的嗎? 哈爾濱,哈爾濱印刷器材公司,錢是匯給他們的,機器肯定就是他們的。 哈爾濱印刷器材公司?這個單位在啥地方? 在哈爾濱唄,具體是哪兒不知道,發票上可能有地址。 你能把發票拿給我看看嗎? 你看發票幹啥?要找他們? </s></s> 就是得找他們!他們這不是坑人嗎?</s>	angry	angry
<s> 那是在哈爾濱,在人家的印刷廠印的。咱們現把清樣拿過去的。 這事是誰幹的?馬軍吧?那個花花公子他能幹啥? 你知道那臺機器是從哪兒買來的嗎? 哈爾濱,哈爾濱印刷器材公司,錢是匯給他們的,機器肯定就是他們的。 哈爾濱印刷器材公司?這個單位在啥地方? 在哈爾濱唄,具體是哪兒不知道,發票上可能有地址。 你能把發票拿給我看看嗎? 你看發票幹啥?要找他們? 就是得找他們!他們這不是坑人嗎? </s></s> 你說,咱們直接去找不太合適吧?</s>	disgust	fear
<s> 那是在哈爾濱,在人家的印刷廠印的。咱們現把清樣拿過去的。 這事是誰幹的?馬軍吧?那個花花公子他能幹啥? 你知道那臺機器是從哪兒買來的嗎? 哈爾濱,哈爾濱印刷器材公司,錢是匯給他們的,機器肯定就是他們的。 哈爾濱印刷器材公司?這個單位在啥地方? 在哈爾濱唄,具體是哪兒不知道,發票上可能有地址。 你能把發票拿給我看看嗎? 你看發票幹啥?要找他們? 就是得找他們!他們這不是坑人嗎? 你說,咱們直接去找不太合適吧? </s></s> 那是不太合適,要調查得領導說話才行。</s>	neutral	fear
<s> 這事是誰幹的?馬軍吧?那個花花公子他能幹啥? 你知道那臺機器是從哪兒買來的嗎? 哈爾濱,哈爾濱印刷器材公司,錢是匯給他們的,機器肯定就是他們的。 哈爾濱印刷器材公司?這個單位在啥地方? 在哈爾濱唄,具體是哪兒不知道,發票上可能有地址。 你能把發票拿給我看看嗎? 你看發票幹啥?要找他們? 就是得找他們!他們這不是坑人嗎? 你說,咱們直接去找不太合適吧? 那是不太合適,要調查得領導說話才行。 </s></s> 有啥不合適的?瞭解瞭解情況嘛,沒有問題更好,萬一有問題呢?咱們也是對公家負責。</s>	neutral	surprise
<s> 你知道那臺機器是從哪兒買來的嗎? 哈爾濱,哈爾濱印刷器材公司,錢是匯給他們的,機器肯定就是他們的。 哈爾濱印刷器材公司?這個單位在啥地方? 在哈爾濱唄,具體是哪兒不知道,發票上可能有地址。 你能把發票拿給我看看嗎? 你看發票幹啥?要找他們? 就是得找他們!他們這不是坑人嗎? 你說,咱們直接去找不太合適吧? 那是不太合適,要調查得領導說話才行。 有啥不合適的?瞭解瞭解情況嘛,沒有問題更好,萬一有問題呢?咱們也是對公家負責。 </s></s> 咱們也不聲張,也不以林業局的名義,以個人的名義隨便問問還不行?</s>	angry	surprise
<s> 哈爾濱,哈爾濱印刷器材公司,錢是匯給他們的,機器肯定就是他們的。 哈爾濱印刷器材公司?這個單位在啥地方? 在哈爾濱唄,具體是哪兒不知道,發票上可能有地址。 你能把發票拿給我看看嗎? 你看發票幹啥?要找他們? 就是得找他們!他們這不是坑人嗎? 你說,咱們直接去找不太合適吧? 那是不太合適,要調查得領導說話才行。 有啥不合適的?瞭解瞭解情況嘛,沒有問題更好,萬一有問題呢?咱們也是對公家負責。 咱們也不聲張,也不以林業局的名義,以個人的名義隨便問問還不行? </s></s> 你不得帶介紹信嗎?</s>	neutral	surprise
<s> 哈爾濱印刷器材公司?這個單位在啥地方? 在哈爾濱唄,具體是哪兒不知道,發票上可能有地址。 你能把發票拿給我看看嗎? 你看發票幹啥?要找他們? 就是得找他們!他們這不是坑人嗎? 你說,咱們直接去找不太合適吧? 那是不太合適,要調查得領導說話才行。 有啥不合適的?瞭解瞭解情況嘛,沒有問題更好,萬一有問題呢?咱們也是對公家負責。 咱們也不聲張,也不以林業局的名義,以個人的名義隨便問問還不行? 你不得帶介紹信嗎? </s></s> 誰能給開介紹信呀?</s>	surprise	fear
<s> 在哈爾濱唄,具體是哪兒不知道,發票上可能有地址。 你能把發票拿給我看看嗎? 你看發票幹啥?要找他們? 就是得找他們!他們這不是坑人嗎? 你說,咱們直接去找不太合適吧? 那是不太合適,要調查得領導說話才行。 有啥不合適的?瞭解瞭解情況嘛,沒有問題更好,萬一有問題呢?咱們也是對公家負責。 咱們也不聲張,也不以林業局的名義,以個人的名義隨便問問還不行? 你不得帶介紹信嗎? 誰能給開介紹信呀? </s></s> 要啥介紹信呀?你把他們的發票帶上,他們開出來的發票還能不認帳?</s>	angry	angry
<s> 你能把發票拿給我看看嗎? 你看發票幹啥?要找他們? 就是得找他們!他們這不是坑人嗎? 你說,咱們直接去找不太合適吧? 那是不太合適,要調查得領導說話才行。 有啥不合適的?瞭解瞭解情況嘛,沒有問題更好,萬一有問題呢?咱們也是對公家負責。 咱們也不聲張,也不以林業局的名義,以個人的名義隨便問問還不行? 你不得帶介紹信嗎? 誰能給開介紹信呀? 要啥介紹信呀?你把他們的發票帶上,他們開出來的發票還能不認帳? </s></s> 對,這倒是個辦法。</s>	neutral	angry
<s> 你看發票幹啥?要找他們? 就是得找他們!他們這不是坑人嗎? 你說,咱們直接去找不太合適吧? 那是不太合適,要調查得領導說話才行。 有啥不合適的?瞭解瞭解情況嘛,沒有問題更好,萬一有問題呢?咱們也是對公家負責。 咱們也不聲張,也不以林業局的名義,以個人的名義隨便問問還不行? 你不得帶介紹信嗎? 誰能給開介紹信呀? 要啥介紹信呀?你把他們的發票帶上,他們開出來的發票還能不認帳? 對,這倒是個辦法。 </s></s> 這個辦法最好。你在商店買衣服,不合適了,要退要換,不都是帶上發票嗎?</s>	angry	neutral
<s> 就是得找他們!他們這不是坑人嗎? 你說,咱們直接去找不太合適吧? 那是不太合適,要調查得領導說話才行。 有啥不合適的?瞭解瞭解情況嘛,沒有問題更好,萬一有問題呢?咱們也是對公家負責。 咱們也不聲張,也不以林業局的名義,以個人的名義隨便問問還不行? 你不得帶介紹信嗎? 誰能給開介紹信呀? 要啥介紹信呀?你把他們的發票帶上,他們開出來的發票還能不認帳? 對,這倒是個辦法。 這個辦法最好。你在商店買衣服,不合適了,要退要換,不都是帶上發票嗎? </s></s> 小蘭,能把發票借用一下嗎?</s>	neutral	surprise
<s></s></s> 你就借給她用用唄!這有啥犯難的?</s>	angry	surprise
<s> 你就借給她用用唄!這有啥犯難的? </s></s> 發票可能都裝訂起來了。</s>	neutral	fear
<s> 你就借給她用用唄!這有啥犯難的? 發票可能都裝訂起來了。 </s></s> 還有個辦法,你把發票拿到外邊去再印一張,跟原來的一模一樣。</s>	joy	joy
<s> 你就借給她用用唄!這有啥犯難的? 發票可能都裝訂起來了。 還有個辦法,你把發票拿到外邊去再印一張,跟原來的一模一樣。 </s></s> 對,複印一張。</s>	joy	joy
<s> 你就借給她用用唄!這有啥犯難的? 發票可能都裝訂起來了。 還有個辦法,你把發票拿到外邊去再印一張,跟原來的一模一樣。 對,複印一張。 </s></s> 小蘭!這個忙你得幫,人家也是爲你們好。今天是禮拜天,辦公室裏沒人,你就把發票拿出來給她!</s>	angry	joy
<s></s></s> 別猶豫了,快吃飯,吃完飯咱們就走!</s>	joy	joy
<s> 別猶豫了,快吃飯,吃完飯咱們就走! </s></s> 好吧。</s>	neutral	fear
<s> 別猶豫了,快吃飯,吃完飯咱們就走! 好吧。 </s></s> 謝謝小蘭姐!盛哥,這事你千萬可別跟別人說,對小蘭不好</s>	joy	joy
<s> 別猶豫了,快吃飯,吃完飯咱們就走! 好吧。 謝謝小蘭姐!盛哥,這事你千萬可別跟別人說,對小蘭不好 </s></s> 我成天在大街上跑,跟誰說去?再說了,她們辦公室那點事兒,全景陽鎮誰不知道,還用我說?</s>	neutral	disgust
<s> 別猶豫了,快吃飯,吃完飯咱們就走! 好吧。 謝謝小蘭姐!盛哥,這事你千萬可別跟別人說,對小蘭不好 我成天在大街上跑,跟誰說去?再說了,她們辦公室那點事兒,全景陽鎮誰不知道,還用我說? </s></s> 她們辦公室啥事兒?</s>	surprise	surprise
<s> 別猶豫了,快吃飯,吃完飯咱們就走! 好吧。 謝謝小蘭姐!盛哥,這事你千萬可別跟別人說,對小蘭不好 我成天在大街上跑,跟誰說去?再說了,她們辦公室那點事兒,全景陽鎮誰不知道,還用我說? 她們辦公室啥事兒? </s></s> 丟錢唄!一下丟了好幾萬,誰不知道林業局有錢?還有那個馬軍小白鴿,仗着他們老爹在局裏當官兒,橫行霸道!</s>	angry	disgust
<s> 別猶豫了,快吃飯,吃完飯咱們就走! 好吧。 謝謝小蘭姐!盛哥,這事你千萬可別跟別人說,對小蘭不好 我成天在大街上跑,跟誰說去?再說了,她們辦公室那點事兒,全景陽鎮誰不知道,還用我說? 她們辦公室啥事兒? 丟錢唄!一下丟了好幾萬,誰不知道林業局有錢?還有那個馬軍小白鴿,仗着他們老爹在局裏當官兒,橫行霸道! </s></s> 得了你!吃飯也堵不住你的嘴。</s>	angry	angry
<s></s></s> 別往前走了,離太近了不好。</s>	fear	fear
<s> 別往前走了,離太近了不好。 </s></s> 我們在這等你。</s>	neutral	neutral
<s> 別往前走了,離太近了不好。 我們在這等你。 </s></s> 別在這等!走遠一點。</s>	neutral	fear
<s> 別往前走了,離太近了不好。 我們在這等你。 別在這等!走遠一點。 </s></s> 我們上火車站等,還能接個活兒。</s>	joy	neutral
<s> 別往前走了,離太近了不好。 我們在這等你。 別在這等!走遠一點。 我們上火車站等,還能接個活兒。 </s></s> 行。</s>	neutral	neutral
<s></s></s> 爺爺,我爸他們勞動服務公司開業,您去了嗎?</s>	neutral	surprise
<s> 爺爺,我爸他們勞動服務公司開業,您去了嗎? </s></s> 我去了。他們非叫我去。其實我是多餘去的。</s>	neutral	neutral
<s> 爺爺,我爸他們勞動服務公司開業,您去了嗎? 我去了。他們非叫我去。其實我是多餘去的。 </s></s> 您是林業局和景陽鎮的元老,是給他們壯聲勢,怎麼是多餘呢?</s>	surprise	joy
<s> 爺爺,我爸他們勞動服務公司開業,您去了嗎? 我去了。他們非叫我去。其實我是多餘去的。 您是林業局和景陽鎮的元老,是給他們壯聲勢,怎麼是多餘呢? </s></s> 對呀,有人想去還沒人請呢!</s>	neutral	joy
<s></s></s> “喂</s>	neutral	neutral
<s> “喂 </s></s> 喂......我是,有什麼事嗎?......旅遊團有人找我?......噢,好好,有時間,我這就過去,賓館208房間,好再見!</s>	surprise	neutral
<s> “喂 喂......我是,有什麼事嗎?......旅遊團有人找我?......噢,好好,有時間,我這就過去,賓館208房間,好再見! </s></s> 誰找您呀?</s>	surprise	surprise
<s> “喂 喂......我是,有什麼事嗎?......旅遊團有人找我?......噢,好好,有時間,我這就過去,賓館208房間,好再見! 誰找您呀? </s></s> 鎮政府的,他們讓我去一趟,說有個旅遊團來了。旅遊團有兩個人沒走,他們認識我,要見見我。</s>	joy	neutral
<s> “喂 喂......我是,有什麼事嗎?......旅遊團有人找我?......噢,好好,有時間,我這就過去,賓館208房間,好再見! 誰找您呀? 鎮政府的,他們讓我去一趟,說有個旅遊團來了。旅遊團有兩個人沒走,他們認識我,要見見我。 </s></s> 您看,還是有人請吧?</s>	joy	joy
<s> “喂 喂......我是,有什麼事嗎?......旅遊團有人找我?......噢,好好,有時間,我這就過去,賓館208房間,好再見! 誰找您呀? 鎮政府的,他們讓我去一趟,說有個旅遊團來了。旅遊團有兩個人沒走,他們認識我,要見見我。 您看,還是有人請吧? </s></s> 哪兒來的旅遊團呀?</s>	surprise	surprise
<s> “喂 喂......我是,有什麼事嗎?......旅遊團有人找我?......噢,好好,有時間,我這就過去,賓館208房間,好再見! 誰找您呀? 鎮政府的,他們讓我去一趟,說有個旅遊團來了。旅遊團有兩個人沒走,他們認識我,要見見我。 您看,還是有人請吧? 哪兒來的旅遊團呀? </s></s> 八成是日本的吧?這幾年來的不盡是日本人嗎?</s>	surprise	neutral
<s> “喂 喂......我是,有什麼事嗎?......旅遊團有人找我?......噢,好好,有時間,我這就過去,賓館208房間,好再見! 誰找您呀? 鎮政府的,他們讓我去一趟,說有個旅遊團來了。旅遊團有兩個人沒走,他們認識我,要見見我。 您看,還是有人請吧? 哪兒來的旅遊團呀? 八成是日本的吧?這幾年來的不盡是日本人嗎? </s></s> 咱景陽鎮還有過日本人?沒聽說過。</s>	surprise	surprise
<s> “喂 喂......我是,有什麼事嗎?......旅遊團有人找我?......噢,好好,有時間,我這就過去,賓館208房間,好再見! 誰找您呀? 鎮政府的,他們讓我去一趟,說有個旅遊團來了。旅遊團有兩個人沒走,他們認識我,要見見我。 您看,還是有人請吧? 哪兒來的旅遊團呀? 八成是日本的吧?這幾年來的不盡是日本人嗎? 咱景陽鎮還有過日本人?沒聽說過。 </s></s> 怎麼沒有?以前鎮西邊有個開拓團,都是日本人。還有日本人在鎮上租老百姓的房子住呢。</s>	surprise	surprise
<s> “喂 喂......我是,有什麼事嗎?......旅遊團有人找我?......噢,好好,有時間,我這就過去,賓館208房間,好再見! 誰找您呀? 鎮政府的,他們讓我去一趟,說有個旅遊團來了。旅遊團有兩個人沒走,他們認識我,要見見我。 您看,還是有人請吧? 哪兒來的旅遊團呀? 八成是日本的吧?這幾年來的不盡是日本人嗎? 咱景陽鎮還有過日本人?沒聽說過。 怎麼沒有?以前鎮西邊有個開拓團,都是日本人。還有日本人在鎮上租老百姓的房子住呢。 </s></s> 您見過?</s>	surprise	surprise
<s> “喂 喂......我是,有什麼事嗎?......旅遊團有人找我?......噢,好好,有時間,我這就過去,賓館208房間,好再見! 誰找您呀? 鎮政府的,他們讓我去一趟,說有個旅遊團來了。旅遊團有兩個人沒走,他們認識我,要見見我。 您看,還是有人請吧? 哪兒來的旅遊團呀? 八成是日本的吧?這幾年來的不盡是日本人嗎? 咱景陽鎮還有過日本人?沒聽說過。 怎麼沒有?以前鎮西邊有個開拓團,都是日本人。還有日本人在鎮上租老百姓的房子住呢。 您見過? </s></s> 那還能沒見過?就不知道這個人是誰?說他還認識我。</s>	surprise	neutral
<s> 喂......我是,有什麼事嗎?......旅遊團有人找我?......噢,好好,有時間,我這就過去,賓館208房間,好再見! 誰找您呀? 鎮政府的,他們讓我去一趟,說有個旅遊團來了。旅遊團有兩個人沒走,他們認識我,要見見我。 您看,還是有人請吧? 哪兒來的旅遊團呀? 八成是日本的吧?這幾年來的不盡是日本人嗎? 咱景陽鎮還有過日本人?沒聽說過。 怎麼沒有?以前鎮西邊有個開拓團,都是日本人。還有日本人在鎮上租老百姓的房子住呢。 您見過? 那還能沒見過?就不知道這個人是誰?說他還認識我。 </s></s> 那您就趕快去吧,咱們家要來日本客人了。</s>	joy	joy
<s> 誰找您呀? 鎮政府的,他們讓我去一趟,說有個旅遊團來了。旅遊團有兩個人沒走,他們認識我,要見見我。 您看,還是有人請吧? 哪兒來的旅遊團呀? 八成是日本的吧?這幾年來的不盡是日本人嗎? 咱景陽鎮還有過日本人?沒聽說過。 怎麼沒有?以前鎮西邊有個開拓團,都是日本人。還有日本人在鎮上租老百姓的房子住呢。 您見過? 那還能沒見過?就不知道這個人是誰?說他還認識我。 那您就趕快去吧,咱們家要來日本客人了。 </s></s> 我可不記得有哪個日本人認識我了。</s>	neutral	surprise
<s></s></s> 山西運城市來了一個人,說他們給咱們匯來了五萬塊錢,買木材,你們倆有印象沒有?</s>	neutral	surprise
<s> 山西運城市來了一個人,說他們給咱們匯來了五萬塊錢,買木材,你們倆有印象沒有? </s></s> 山西運城?沒印象。</s>	surprise	surprise
<s> 山西運城市來了一個人,說他們給咱們匯來了五萬塊錢,買木材,你們倆有印象沒有? 山西運城?沒印象。 </s></s> 山西運城?聽都沒聽說過。他那麼老遠,給咱們匯什麼錢呀?</s>	surprise	surprise
<s> 山西運城市來了一個人,說他們給咱們匯來了五萬塊錢,買木材,你們倆有印象沒有? 山西運城?沒印象。 山西運城?聽都沒聽說過。他那麼老遠,給咱們匯什麼錢呀? </s></s> 他說是專門買咱們水曲柳的。</s>	neutral	fear
<s> 山西運城市來了一個人,說他們給咱們匯來了五萬塊錢,買木材,你們倆有印象沒有? 山西運城?沒印象。 山西運城?聽都沒聽說過。他那麼老遠,給咱們匯什麼錢呀? 他說是專門買咱們水曲柳的。 </s></s> 他們來人了?</s>	surprise	surprise
<s> 山西運城市來了一個人,說他們給咱們匯來了五萬塊錢,買木材,你們倆有印象沒有? 山西運城?沒印象。 山西運城?聽都沒聽說過。他那麼老遠,給咱們匯什麼錢呀? 他說是專門買咱們水曲柳的。 他們來人了? </s></s> 是呀,來人了。</s>	joy	fear
<s> 山西運城市來了一個人,說他們給咱們匯來了五萬塊錢,買木材,你們倆有印象沒有? 山西運城?沒印象。 山西運城?聽都沒聽說過。他那麼老遠,給咱們匯什麼錢呀? 他說是專門買咱們水曲柳的。 他們來人了? 是呀,來人了。 </s></s> 那就給他查一下吧。不過沒那麼快,得上銀行查,一筆一筆地對,讓他等一等吧。</s>	neutral	neutral
<s> 山西運城市來了一個人,說他們給咱們匯來了五萬塊錢,買木材,你們倆有印象沒有? 山西運城?沒印象。 山西運城?聽都沒聽說過。他那麼老遠,給咱們匯什麼錢呀? 他說是專門買咱們水曲柳的。 他們來人了? 是呀,來人了。 那就給他查一下吧。不過沒那麼快,得上銀行查,一筆一筆地對,讓他等一等吧。 </s></s> 那沒問題,你就給查一下吧,我讓他明天再來。</s>	neutral	neutral
<s></s></s> 徐姐,你上哈爾濱去過嗎?</s>	neutral	surprise
<s> 徐姐,你上哈爾濱去過嗎? </s></s> 去過,就去過一次。</s>	joy	neutral
<s> 徐姐,你上哈爾濱去過嗎? 去過,就去過一次。 </s></s> 我一次都沒去過。</s>	neutral	sadness
<s> 徐姐,你上哈爾濱去過嗎? 去過,就去過一次。 我一次都沒去過。 </s></s> 這回不就有機會了嗎?可能還得去好幾次呢。</s>	joy	joy
<s> 徐姐,你上哈爾濱去過嗎? 去過,就去過一次。 我一次都沒去過。 這回不就有機會了嗎?可能還得去好幾次呢。 </s></s> 印刷廠的地址你知道嗎?</s>	neutral	surprise
<s> 徐姐,你上哈爾濱去過嗎? 去過,就去過一次。 我一次都沒去過。 這回不就有機會了嗎?可能還得去好幾次呢。 印刷廠的地址你知道嗎? </s></s> 知道,在道里區,百貨大樓附近,是哈爾濱印刷器材公司,不是印刷廠,離火車站不遠。</s>	neutral	neutral
<s> 徐姐,你上哈爾濱去過嗎? 去過,就去過一次。 我一次都沒去過。 這回不就有機會了嗎?可能還得去好幾次呢。 印刷廠的地址你知道嗎? 知道,在道里區,百貨大樓附近,是哈爾濱印刷器材公司,不是印刷廠,離火車站不遠。 </s></s> 完事了咱們上哪兒去玩呀?</s>	surprise	joy
<s> 徐姐,你上哈爾濱去過嗎? 去過,就去過一次。 我一次都沒去過。 這回不就有機會了嗎?可能還得去好幾次呢。 印刷廠的地址你知道嗎? 知道,在道里區,百貨大樓附近,是哈爾濱印刷器材公司,不是印刷廠,離火車站不遠。 完事了咱們上哪兒去玩呀? </s></s> 道里好玩的地方挺多的,兆麟公園、江邊的斯大林公園、太陽島公園,還有哈爾濱最大的百貨公司,哈一百。</s>	joy	joy
<s> 徐姐,你上哈爾濱去過嗎? 去過,就去過一次。 我一次都沒去過。 這回不就有機會了嗎?可能還得去好幾次呢。 印刷廠的地址你知道嗎? 知道,在道里區,百貨大樓附近,是哈爾濱印刷器材公司,不是印刷廠,離火車站不遠。 完事了咱們上哪兒去玩呀? 道里好玩的地方挺多的,兆麟公園、江邊的斯大林公園、太陽島公園,還有哈爾濱最大的百貨公司,哈一百。 </s></s> 啥叫哈一百?</s>	surprise	surprise
<s> 徐姐,你上哈爾濱去過嗎? 去過,就去過一次。 我一次都沒去過。 這回不就有機會了嗎?可能還得去好幾次呢。 印刷廠的地址你知道嗎? 知道,在道里區,百貨大樓附近,是哈爾濱印刷器材公司,不是印刷廠,離火車站不遠。 完事了咱們上哪兒去玩呀? 道里好玩的地方挺多的,兆麟公園、江邊的斯大林公園、太陽島公園,還有哈爾濱最大的百貨公司,哈一百。 啥叫哈一百? </s></s> 哈爾濱第一百貨公司,就叫哈一百。那裏夠你逛一天的。</s>	joy	joy
<s></s></s> 這哪有印刷公司的影子呀?不是說在一百附近嗎?</s>	surprise	surprise
<s> 這哪有印刷公司的影子呀?不是說在一百附近嗎? </s></s> 不是咱們家,說附近一眼就能看見。這是大城市,大老遠的地方也是附近。問問吧。</s>	neutral	neutral
<s></s></s> 我們是景陽林業局的。我們跟你們有一筆銷售業務想打聽一下。</s>	neutral	neutral
<s> 我們是景陽林業局的。我們跟你們有一筆銷售業務想打聽一下。 </s></s> 有銷售業務?</s>	surprise	surprise
<s> 我們是景陽林業局的。我們跟你們有一筆銷售業務想打聽一下。 有銷售業務? </s></s> 是,從你們公司買了兩臺印刷機。</s>	neutral	neutral
<s> 我們是景陽林業局的。我們跟你們有一筆銷售業務想打聽一下。 有銷售業務? 是,從你們公司買了兩臺印刷機。 </s></s> 買了兩臺印刷機?有合同嗎?</s>	surprise	surprise
<s> 我們是景陽林業局的。我們跟你們有一筆銷售業務想打聽一下。 有銷售業務? 是,從你們公司買了兩臺印刷機。 買了兩臺印刷機?有合同嗎? </s></s> 沒有合同。</s>	neutral	neutral
<s> 我們是景陽林業局的。我們跟你們有一筆銷售業務想打聽一下。 有銷售業務? 是,從你們公司買了兩臺印刷機。 買了兩臺印刷機?有合同嗎? 沒有合同。 </s></s> 不對吧,我們銷售器材都是有合同的,沒有合同我們不賣貨。</s>	neutral	surprise
<s> 我們是景陽林業局的。我們跟你們有一筆銷售業務想打聽一下。 有銷售業務? 是,從你們公司買了兩臺印刷機。 買了兩臺印刷機?有合同嗎? 沒有合同。 不對吧,我們銷售器材都是有合同的,沒有合同我們不賣貨。 </s></s> 有發票。</s>	neutral	angry
<s></s></s> 這是我門王經理的電話和通信地址。我叫徐麗,你可以直接跟王經理和我聯繫。</s>	neutral	joy
<s> 這是我門王經理的電話和通信地址。我叫徐麗,你可以直接跟王經理和我聯繫。 </s></s> 好的,你放心吧。</s>	joy	joy
<s> 這是我門王經理的電話和通信地址。我叫徐麗,你可以直接跟王經理和我聯繫。 好的,你放心吧。 </s></s> 蔡科長,再見!</s>	joy	joy
<s> 這是我門王經理的電話和通信地址。我叫徐麗,你可以直接跟王經理和我聯繫。 好的,你放心吧。 蔡科長,再見! </s></s> 再見!</s>	joy	joy
<s></s></s> 他怎麼說機器不是他們賣的?發票也不是他們的?</s>	angry	surprise
<s> 他怎麼說機器不是他們賣的?發票也不是他們的? </s></s> 他倒沒徹底否認發票是他們的,好像這個開發票的人他們不認識,不是他們的人。</s>	disgust	fear
<s> 他怎麼說機器不是他們賣的?發票也不是他們的? 他倒沒徹底否認發票是他們的,好像這個開發票的人他們不認識,不是他們的人。 </s></s> 不是他們的人還能開他們的發票嗎?</s>	angry	surprise
<s> 他怎麼說機器不是他們賣的?發票也不是他們的? 他倒沒徹底否認發票是他們的,好像這個開發票的人他們不認識,不是他們的人。 不是他們的人還能開他們的發票嗎? </s></s> 不是他們的人是指不是他們銷售科的人,是別的科裏的人代他們開的。</s>	neutral	neutral
<s> 他怎麼說機器不是他們賣的?發票也不是他們的? 他倒沒徹底否認發票是他們的,好像這個開發票的人他們不認識,不是他們的人。 不是他們的人還能開他們的發票嗎? 不是他們的人是指不是他們銷售科的人,是別的科裏的人代他們開的。 </s></s> 他們爲啥要找人代開發票呢?</s>	surprise	surprise
<s> 他怎麼說機器不是他們賣的?發票也不是他們的? 他倒沒徹底否認發票是他們的,好像這個開發票的人他們不認識,不是他們的人。 不是他們的人還能開他們的發票嗎? 不是他們的人是指不是他們銷售科的人,是別的科裏的人代他們開的。 他們爲啥要找人代開發票呢? </s></s> 看來這裏確實有問題。他們說他們賣的機器不可能不是新的。可咱們廠的師傅說,那機器根本就不是新的,來的時候缺配件,換了配件還不能用。</s>	sadness	angry
<s> 他怎麼說機器不是他們賣的?發票也不是他們的? 他倒沒徹底否認發票是他們的,好像這個開發票的人他們不認識,不是他們的人。 不是他們的人還能開他們的發票嗎? 不是他們的人是指不是他們銷售科的人,是別的科裏的人代他們開的。 他們爲啥要找人代開發票呢? 看來這裏確實有問題。他們說他們賣的機器不可能不是新的。可咱們廠的師傅說,那機器根本就不是新的,來的時候缺配件,換了配件還不能用。 </s></s> 那怎麼辦?</s>	fear	fear
<s> 他怎麼說機器不是他們賣的?發票也不是他們的? 他倒沒徹底否認發票是他們的,好像這個開發票的人他們不認識,不是他們的人。 不是他們的人還能開他們的發票嗎? 不是他們的人是指不是他們銷售科的人,是別的科裏的人代他們開的。 他們爲啥要找人代開發票呢? 看來這裏確實有問題。他們說他們賣的機器不可能不是新的。可咱們廠的師傅說,那機器根本就不是新的,來的時候缺配件,換了配件還不能用。 那怎麼辦? </s></s> 得先弄清楚,這機器到底是誰家的?</s>	surprise	surprise
<s> 他怎麼說機器不是他們賣的?發票也不是他們的? 他倒沒徹底否認發票是他們的,好像這個開發票的人他們不認識,不是他們的人。 不是他們的人還能開他們的發票嗎? 不是他們的人是指不是他們銷售科的人,是別的科裏的人代他們開的。 他們爲啥要找人代開發票呢? 看來這裏確實有問題。他們說他們賣的機器不可能不是新的。可咱們廠的師傅說,那機器根本就不是新的,來的時候缺配件,換了配件還不能用。 那怎麼辦? 得先弄清楚,這機器到底是誰家的? </s></s> 怎麼弄清楚?問問馬廠長?</s>	surprise	surprise
<s> 他怎麼說機器不是他們賣的?發票也不是他們的? 他倒沒徹底否認發票是他們的,好像這個開發票的人他們不認識,不是他們的人。 不是他們的人還能開他們的發票嗎? 不是他們的人是指不是他們銷售科的人,是別的科裏的人代他們開的。 他們爲啥要找人代開發票呢? 看來這裏確實有問題。他們說他們賣的機器不可能不是新的。可咱們廠的師傅說,那機器根本就不是新的,來的時候缺配件,換了配件還不能用。 那怎麼辦? 得先弄清楚,這機器到底是誰家的? 怎麼弄清楚?問問馬廠長? </s></s> 不能問他!</s>	angry	disgust
<s> 他怎麼說機器不是他們賣的?發票也不是他們的? 他倒沒徹底否認發票是他們的,好像這個開發票的人他們不認識,不是他們的人。 不是他們的人還能開他們的發票嗎? 不是他們的人是指不是他們銷售科的人,是別的科裏的人代他們開的。 他們爲啥要找人代開發票呢? 看來這裏確實有問題。他們說他們賣的機器不可能不是新的。可咱們廠的師傅說,那機器根本就不是新的,來的時候缺配件,換了配件還不能用。 那怎麼辦? 得先弄清楚,這機器到底是誰家的? 怎麼弄清楚?問問馬廠長? 不能問他! </s></s> 機器是他買的,不問他問誰?</s>	angry	surprise
<s> 他倒沒徹底否認發票是他們的,好像這個開發票的人他們不認識,不是他們的人。 不是他們的人還能開他們的發票嗎? 不是他們的人是指不是他們銷售科的人,是別的科裏的人代他們開的。 他們爲啥要找人代開發票呢? 看來這裏確實有問題。他們說他們賣的機器不可能不是新的。可咱們廠的師傅說,那機器根本就不是新的,來的時候缺配件,換了配件還不能用。 那怎麼辦? 得先弄清楚,這機器到底是誰家的? 怎麼弄清楚?問問馬廠長? 不能問他! 機器是他買的,不問他問誰? </s></s> 回去!問廠裏的師傅。</s>	angry	angry
<s> 不是他們的人還能開他們的發票嗎? 不是他們的人是指不是他們銷售科的人,是別的科裏的人代他們開的。 他們爲啥要找人代開發票呢? 看來這裏確實有問題。他們說他們賣的機器不可能不是新的。可咱們廠的師傅說,那機器根本就不是新的,來的時候缺配件,換了配件還不能用。 那怎麼辦? 得先弄清楚,這機器到底是誰家的? 怎麼弄清楚?問問馬廠長? 不能問他! 機器是他買的,不問他問誰? 回去!問廠裏的師傅。 </s></s> 那咱們這一趟算白來了。</s>	neutral	sadness
<s> 不是他們的人是指不是他們銷售科的人,是別的科裏的人代他們開的。 他們爲啥要找人代開發票呢? 看來這裏確實有問題。他們說他們賣的機器不可能不是新的。可咱們廠的師傅說,那機器根本就不是新的,來的時候缺配件,換了配件還不能用。 那怎麼辦? 得先弄清楚,這機器到底是誰家的? 怎麼弄清楚?問問馬廠長? 不能問他! 機器是他買的,不問他問誰? 回去!問廠裏的師傅。 那咱們這一趟算白來了。 </s></s> 也不白來。</s>	neutral	neutral
<s> 他們爲啥要找人代開發票呢? 看來這裏確實有問題。他們說他們賣的機器不可能不是新的。可咱們廠的師傅說,那機器根本就不是新的,來的時候缺配件,換了配件還不能用。 那怎麼辦? 得先弄清楚,這機器到底是誰家的? 怎麼弄清楚?問問馬廠長? 不能問他! 機器是他買的,不問他問誰? 回去!問廠裏的師傅。 那咱們這一趟算白來了。 也不白來。 </s></s> 可咱們哪也沒逛,先逛逛哈爾濱大百貨吧,都到跟前了。</s>	neutral	joy
<s> 看來這裏確實有問題。他們說他們賣的機器不可能不是新的。可咱們廠的師傅說,那機器根本就不是新的,來的時候缺配件,換了配件還不能用。 那怎麼辦? 得先弄清楚,這機器到底是誰家的? 怎麼弄清楚?問問馬廠長? 不能問他! 機器是他買的,不問他問誰? 回去!問廠裏的師傅。 那咱們這一趟算白來了。 也不白來。 可咱們哪也沒逛,先逛逛哈爾濱大百貨吧,都到跟前了。 </s></s> 你想買啥?</s>	surprise	surprise
<s> 那怎麼辦? 得先弄清楚,這機器到底是誰家的? 怎麼弄清楚?問問馬廠長? 不能問他! 機器是他買的,不問他問誰? 回去!問廠裏的師傅。 那咱們這一趟算白來了。 也不白來。 可咱們哪也沒逛,先逛逛哈爾濱大百貨吧,都到跟前了。 你想買啥? </s></s> 不買啥。</s>	neutral	neutral
<s> 得先弄清楚,這機器到底是誰家的? 怎麼弄清楚?問問馬廠長? 不能問他! 機器是他買的,不問他問誰? 回去!問廠裏的師傅。 那咱們這一趟算白來了。 也不白來。 可咱們哪也沒逛,先逛逛哈爾濱大百貨吧,都到跟前了。 你想買啥? 不買啥。 </s></s> 不買啥還逛啥?趕緊回去!</s>	angry	surprise
<s> 怎麼弄清楚?問問馬廠長? 不能問他! 機器是他買的,不問他問誰? 回去!問廠裏的師傅。 那咱們這一趟算白來了。 也不白來。 可咱們哪也沒逛,先逛逛哈爾濱大百貨吧,都到跟前了。 你想買啥? 不買啥。 不買啥還逛啥?趕緊回去! </s></s> 逛完了再回去吧?</s>	neutral	joy
<s> 不能問他! 機器是他買的,不問他問誰? 回去!問廠裏的師傅。 那咱們這一趟算白來了。 也不白來。 可咱們哪也沒逛,先逛逛哈爾濱大百貨吧,都到跟前了。 你想買啥? 不買啥。 不買啥還逛啥?趕緊回去! 逛完了再回去吧? </s></s> 不行!耽誤了時間今天就回不去了,走。</s>	disgust	surprise
<s></s></s> 我是馬洪偉,聽說有位外國朋友要見我,請問他在哪兒?</s>	neutral	surprise
<s> 我是馬洪偉,聽說有位外國朋友要見我,請問他在哪兒? </s></s> 噢,您是馬書記?請跟我來。</s>	surprise	joy
<s></s></s> 外賓馬上就回來,請您先休息一下。</s>	neutral	neutral
<s> 外賓馬上就回來,請您先休息一下。 </s></s> 對不起,我不會說日本話。你是......</s>	fear	surprise
<s></s></s> 對,對,是木材加工廠。那時候剛解放,還沒成立林業局,就是個木材加工廠,人也不多,條件不好,工人幹活很苦,也沒有機械。</s>	neutral	surprise
<s> 對,對,是木材加工廠。那時候剛解放,還沒成立林業局,就是個木材加工廠,人也不多,條件不好,工人幹活很苦,也沒有機械。 </s></s> 那時候廠裏工人有好幾百,我乾的時間又不長,你不會認識我。但是我知道你,因爲你是廠長。</s>	joy	joy
<s> 對,對,是木材加工廠。那時候剛解放,還沒成立林業局,就是個木材加工廠,人也不多,條件不好,工人幹活很苦,也沒有機械。 那時候廠裏工人有好幾百,我乾的時間又不長,你不會認識我。但是我知道你,因爲你是廠長。 </s></s> 那你現在是從哪兒來的?怎麼又成外賓了?</s>	surprise	surprise
<s> 對,對,是木材加工廠。那時候剛解放,還沒成立林業局,就是個木材加工廠,人也不多,條件不好,工人幹活很苦,也沒有機械。 那時候廠裏工人有好幾百,我乾的時間又不長,你不會認識我。但是我知道你,因爲你是廠長。 那你現在是從哪兒來的?怎麼又成外賓了? </s></s> 馬先生可能不知道,我雖是咱們景陽鎮的老鄉,但我不是中國人。怎麼說呢?我先是朝鮮人,後來是中國人,現在呢,我又是朝鮮——噢不,是韓國人。事情是這樣的。我的祖先是朝鮮人。在我六歲的時候,跟着家里人從日本佔領下的朝鮮半島跑到了中國東北,在東北一路逃荒來到景陽鎮,在這裏落了戶。後來中國東北也給日本人佔了,咱們都成了亡國奴,一直到蘇聯紅軍解放了全東北。一九五零年抗美援朝戰爭爆發,我參加志願軍到了朝鮮,一去就沒回來。</s>	neutral	sadness
<s></s></s> 我到朝鮮不久,趕上仁川戰役。在那次戰役中我被俘了。</s>	neutral	sadness
<s> 我到朝鮮不久,趕上仁川戰役。在那次戰役中我被俘了。 </s></s> 馬廠長,在景陽鎮,除了家人之外我就認識你一個人,家人我還沒找到。你比我大,是我的兄長,又是我的上司。有些話在我心裏已經擱了四十年了,今天見到你,我終於可以說出來了,也只有跟你說了。</s>	neutral	joy
<s> 我到朝鮮不久,趕上仁川戰役。在那次戰役中我被俘了。 馬廠長,在景陽鎮,除了家人之外我就認識你一個人,家人我還沒找到。你比我大,是我的兄長,又是我的上司。有些話在我心裏已經擱了四十年了,今天見到你,我終於可以說出來了,也只有跟你說了。 </s></s> 馬廠長,我對不起家鄉父老,愧對東北鄉親呀。我當戰俘的事你們大概早就知道了。我在戰俘營裏幾年,吃了不少苦,受了不少罪。可是吃苦受罪的不光我一個。千不該萬不該我後來沒和同志們一塊回祖國來。我請求留在了南朝鮮。我感到無顏面見鄉親。這也是我這麼多年遲遲不敢回來,甚至不敢同家裏聯繫的原因。</s>	sadness	sadness
<s> 我到朝鮮不久,趕上仁川戰役。在那次戰役中我被俘了。 馬廠長,在景陽鎮,除了家人之外我就認識你一個人,家人我還沒找到。你比我大,是我的兄長,又是我的上司。有些話在我心裏已經擱了四十年了,今天見到你,我終於可以說出來了,也只有跟你說了。 馬廠長,我對不起家鄉父老,愧對東北鄉親呀。我當戰俘的事你們大概早就知道了。我在戰俘營裏幾年,吃了不少苦,受了不少罪。可是吃苦受罪的不光我一個。千不該萬不該我後來沒和同志們一塊回祖國來。我請求留在了南朝鮮。我感到無顏面見鄉親。這也是我這麼多年遲遲不敢回來,甚至不敢同家裏聯繫的原因。 </s></s> 不不,應該回來,應該回來!回來就好。這麼說韓先生是從景陽鎮參軍的了?</s>	neutral	joy
<s> 我到朝鮮不久,趕上仁川戰役。在那次戰役中我被俘了。 馬廠長,在景陽鎮,除了家人之外我就認識你一個人,家人我還沒找到。你比我大,是我的兄長,又是我的上司。有些話在我心裏已經擱了四十年了,今天見到你,我終於可以說出來了,也只有跟你說了。 馬廠長,我對不起家鄉父老,愧對東北鄉親呀。我當戰俘的事你們大概早就知道了。我在戰俘營裏幾年,吃了不少苦,受了不少罪。可是吃苦受罪的不光我一個。千不該萬不該我後來沒和同志們一塊回祖國來。我請求留在了南朝鮮。我感到無顏面見鄉親。這也是我這麼多年遲遲不敢回來,甚至不敢同家裏聯繫的原因。 不不,應該回來,應該回來!回來就好。這麼說韓先生是從景陽鎮參軍的了? </s></s> 是的。</s>	neutral	neutral
<s> 我到朝鮮不久,趕上仁川戰役。在那次戰役中我被俘了。 馬廠長,在景陽鎮,除了家人之外我就認識你一個人,家人我還沒找到。你比我大,是我的兄長,又是我的上司。有些話在我心裏已經擱了四十年了,今天見到你,我終於可以說出來了,也只有跟你說了。 馬廠長,我對不起家鄉父老,愧對東北鄉親呀。我當戰俘的事你們大概早就知道了。我在戰俘營裏幾年,吃了不少苦,受了不少罪。可是吃苦受罪的不光我一個。千不該萬不該我後來沒和同志們一塊回祖國來。我請求留在了南朝鮮。我感到無顏面見鄉親。這也是我這麼多年遲遲不敢回來,甚至不敢同家裏聯繫的原因。 不不,應該回來,應該回來!回來就好。這麼說韓先生是從景陽鎮參軍的了? 是的。 </s></s> 你走的時候家裏都有什麼人?</s>	neutral	surprise
<s> 我到朝鮮不久,趕上仁川戰役。在那次戰役中我被俘了。 馬廠長,在景陽鎮,除了家人之外我就認識你一個人,家人我還沒找到。你比我大,是我的兄長,又是我的上司。有些話在我心裏已經擱了四十年了,今天見到你,我終於可以說出來了,也只有跟你說了。 馬廠長,我對不起家鄉父老,愧對東北鄉親呀。我當戰俘的事你們大概早就知道了。我在戰俘營裏幾年,吃了不少苦,受了不少罪。可是吃苦受罪的不光我一個。千不該萬不該我後來沒和同志們一塊回祖國來。我請求留在了南朝鮮。我感到無顏面見鄉親。這也是我這麼多年遲遲不敢回來,甚至不敢同家裏聯繫的原因。 不不,應該回來,應該回來!回來就好。這麼說韓先生是從景陽鎮參軍的了? 是的。 你走的時候家裏都有什麼人? </s></s> 我的家裏就我老婆一個人,我們結婚不久。我還有一個弟弟跟我們一起過。我們老家兄弟三人,我行二,人稱我老兩。我還有一個哥哥和一個姐姐。我們到中國來的時候,我大哥和姐姐留在了朝鮮,就我和老三跟隨父母親過來了。父母親早就過世了。</s>	neutral	sadness
<s> 我到朝鮮不久,趕上仁川戰役。在那次戰役中我被俘了。 馬廠長,在景陽鎮,除了家人之外我就認識你一個人,家人我還沒找到。你比我大,是我的兄長,又是我的上司。有些話在我心裏已經擱了四十年了,今天見到你,我終於可以說出來了,也只有跟你說了。 馬廠長,我對不起家鄉父老,愧對東北鄉親呀。我當戰俘的事你們大概早就知道了。我在戰俘營裏幾年,吃了不少苦,受了不少罪。可是吃苦受罪的不光我一個。千不該萬不該我後來沒和同志們一塊回祖國來。我請求留在了南朝鮮。我感到無顏面見鄉親。這也是我這麼多年遲遲不敢回來,甚至不敢同家裏聯繫的原因。 不不,應該回來,應該回來!回來就好。這麼說韓先生是從景陽鎮參軍的了? 是的。 你走的時候家裏都有什麼人? 我的家裏就我老婆一個人,我們結婚不久。我還有一個弟弟跟我們一起過。我們老家兄弟三人,我行二,人稱我老兩。我還有一個哥哥和一個姐姐。我們到中國來的時候,我大哥和姐姐留在了朝鮮,就我和老三跟隨父母親過來了。父母親早就過世了。 </s></s> 你的三弟在哪兒?</s>	neutral	surprise
<s> 我到朝鮮不久,趕上仁川戰役。在那次戰役中我被俘了。 馬廠長,在景陽鎮,除了家人之外我就認識你一個人,家人我還沒找到。你比我大,是我的兄長,又是我的上司。有些話在我心裏已經擱了四十年了,今天見到你,我終於可以說出來了,也只有跟你說了。 馬廠長,我對不起家鄉父老,愧對東北鄉親呀。我當戰俘的事你們大概早就知道了。我在戰俘營裏幾年,吃了不少苦,受了不少罪。可是吃苦受罪的不光我一個。千不該萬不該我後來沒和同志們一塊回祖國來。我請求留在了南朝鮮。我感到無顏面見鄉親。這也是我這麼多年遲遲不敢回來,甚至不敢同家裏聯繫的原因。 不不,應該回來,應該回來!回來就好。這麼說韓先生是從景陽鎮參軍的了? 是的。 你走的時候家裏都有什麼人? 我的家裏就我老婆一個人,我們結婚不久。我還有一個弟弟跟我們一起過。我們老家兄弟三人,我行二,人稱我老兩。我還有一個哥哥和一個姐姐。我們到中國來的時候,我大哥和姐姐留在了朝鮮,就我和老三跟隨父母親過來了。父母親早就過世了。 你的三弟在哪兒? </s></s> 我走的時候他在景陽鎮,現在不知道在哪兒。四十年了,他應該早就成家了。我這次回來就是爲了打聽我的妻子和三弟的消息,來看看他們。</s>	neutral	sadness
<s> 我到朝鮮不久,趕上仁川戰役。在那次戰役中我被俘了。 馬廠長,在景陽鎮,除了家人之外我就認識你一個人,家人我還沒找到。你比我大,是我的兄長,又是我的上司。有些話在我心裏已經擱了四十年了,今天見到你,我終於可以說出來了,也只有跟你說了。 馬廠長,我對不起家鄉父老,愧對東北鄉親呀。我當戰俘的事你們大概早就知道了。我在戰俘營裏幾年,吃了不少苦,受了不少罪。可是吃苦受罪的不光我一個。千不該萬不該我後來沒和同志們一塊回祖國來。我請求留在了南朝鮮。我感到無顏面見鄉親。這也是我這麼多年遲遲不敢回來,甚至不敢同家裏聯繫的原因。 不不,應該回來,應該回來!回來就好。這麼說韓先生是從景陽鎮參軍的了? 是的。 你走的時候家裏都有什麼人? 我的家裏就我老婆一個人,我們結婚不久。我還有一個弟弟跟我們一起過。我們老家兄弟三人,我行二,人稱我老兩。我還有一個哥哥和一個姐姐。我們到中國來的時候,我大哥和姐姐留在了朝鮮,就我和老三跟隨父母親過來了。父母親早就過世了。 你的三弟在哪兒? 我走的時候他在景陽鎮,現在不知道在哪兒。四十年了,他應該早就成家了。我這次回來就是爲了打聽我的妻子和三弟的消息,來看看他們。 </s></s> 只要他們還在,我們一定會幫你找到他們的,這你放心。我想,如果不發生什麼意外,他們也不會不在。</s>	neutral	joy
<s> 我到朝鮮不久,趕上仁川戰役。在那次戰役中我被俘了。 馬廠長,在景陽鎮,除了家人之外我就認識你一個人,家人我還沒找到。你比我大,是我的兄長,又是我的上司。有些話在我心裏已經擱了四十年了,今天見到你,我終於可以說出來了,也只有跟你說了。 馬廠長,我對不起家鄉父老,愧對東北鄉親呀。我當戰俘的事你們大概早就知道了。我在戰俘營裏幾年,吃了不少苦,受了不少罪。可是吃苦受罪的不光我一個。千不該萬不該我後來沒和同志們一塊回祖國來。我請求留在了南朝鮮。我感到無顏面見鄉親。這也是我這麼多年遲遲不敢回來,甚至不敢同家裏聯繫的原因。 不不,應該回來,應該回來!回來就好。這麼說韓先生是從景陽鎮參軍的了? 是的。 你走的時候家裏都有什麼人? 我的家裏就我老婆一個人,我們結婚不久。我還有一個弟弟跟我們一起過。我們老家兄弟三人,我行二,人稱我老兩。我還有一個哥哥和一個姐姐。我們到中國來的時候,我大哥和姐姐留在了朝鮮,就我和老三跟隨父母親過來了。父母親早就過世了。 你的三弟在哪兒? 我走的時候他在景陽鎮,現在不知道在哪兒。四十年了,他應該早就成家了。我這次回來就是爲了打聽我的妻子和三弟的消息,來看看他們。 只要他們還在,我們一定會幫你找到他們的,這你放心。我想,如果不發生什麼意外,他們也不會不在。 </s></s> 一晃四十年了。人這一輩子,也不過就這麼三、四十年的事,是悲是喜,是福是禍,往往就是一步之差。當年我參加志願軍不光是響應號召,也是想到朝鮮去看看我大哥和大姐。不想朝鮮分成了南北兩半,南北朝鮮兩個世界。他們是在南朝鮮,不但見不着面,連打聽都沒法打聽。後來我成了戰俘,心想這回這條命算是白扔了,兩頭都夠不着了。沒曾想我命大,居然沒死。於是我又產生了新的希望。停戰後遣返戰俘的時候,我說我在南朝鮮有親人,要求不回中國,也就把我留下了。</s>	neutral	sadness
<s> 馬廠長,在景陽鎮,除了家人之外我就認識你一個人,家人我還沒找到。你比我大,是我的兄長,又是我的上司。有些話在我心裏已經擱了四十年了,今天見到你,我終於可以說出來了,也只有跟你說了。 馬廠長,我對不起家鄉父老,愧對東北鄉親呀。我當戰俘的事你們大概早就知道了。我在戰俘營裏幾年,吃了不少苦,受了不少罪。可是吃苦受罪的不光我一個。千不該萬不該我後來沒和同志們一塊回祖國來。我請求留在了南朝鮮。我感到無顏面見鄉親。這也是我這麼多年遲遲不敢回來,甚至不敢同家裏聯繫的原因。 不不,應該回來,應該回來!回來就好。這麼說韓先生是從景陽鎮參軍的了? 是的。 你走的時候家裏都有什麼人? 我的家裏就我老婆一個人,我們結婚不久。我還有一個弟弟跟我們一起過。我們老家兄弟三人,我行二,人稱我老兩。我還有一個哥哥和一個姐姐。我們到中國來的時候,我大哥和姐姐留在了朝鮮,就我和老三跟隨父母親過來了。父母親早就過世了。 你的三弟在哪兒? 我走的時候他在景陽鎮,現在不知道在哪兒。四十年了,他應該早就成家了。我這次回來就是爲了打聽我的妻子和三弟的消息,來看看他們。 只要他們還在,我們一定會幫你找到他們的,這你放心。我想,如果不發生什麼意外,他們也不會不在。 一晃四十年了。人這一輩子,也不過就這麼三、四十年的事,是悲是喜,是福是禍,往往就是一步之差。當年我參加志願軍不光是響應號召,也是想到朝鮮去看看我大哥和大姐。不想朝鮮分成了南北兩半,南北朝鮮兩個世界。他們是在南朝鮮,不但見不着面,連打聽都沒法打聽。後來我成了戰俘,心想這回這條命算是白扔了,兩頭都夠不着了。沒曾想我命大,居然沒死。於是我又產生了新的希望。停戰後遣返戰俘的時候,我說我在南朝鮮有親人,要求不回中國,也就把我留下了。 </s></s> 你找到他們了嗎?</s>	neutral	surprise
<s> 馬廠長,我對不起家鄉父老,愧對東北鄉親呀。我當戰俘的事你們大概早就知道了。我在戰俘營裏幾年,吃了不少苦,受了不少罪。可是吃苦受罪的不光我一個。千不該萬不該我後來沒和同志們一塊回祖國來。我請求留在了南朝鮮。我感到無顏面見鄉親。這也是我這麼多年遲遲不敢回來,甚至不敢同家裏聯繫的原因。 不不,應該回來,應該回來!回來就好。這麼說韓先生是從景陽鎮參軍的了? 是的。 你走的時候家裏都有什麼人? 我的家裏就我老婆一個人,我們結婚不久。我還有一個弟弟跟我們一起過。我們老家兄弟三人,我行二,人稱我老兩。我還有一個哥哥和一個姐姐。我們到中國來的時候,我大哥和姐姐留在了朝鮮,就我和老三跟隨父母親過來了。父母親早就過世了。 你的三弟在哪兒? 我走的時候他在景陽鎮,現在不知道在哪兒。四十年了,他應該早就成家了。我這次回來就是爲了打聽我的妻子和三弟的消息,來看看他們。 只要他們還在,我們一定會幫你找到他們的,這你放心。我想,如果不發生什麼意外,他們也不會不在。 一晃四十年了。人這一輩子,也不過就這麼三、四十年的事,是悲是喜,是福是禍,往往就是一步之差。當年我參加志願軍不光是響應號召,也是想到朝鮮去看看我大哥和大姐。不想朝鮮分成了南北兩半,南北朝鮮兩個世界。他們是在南朝鮮,不但見不着面,連打聽都沒法打聽。後來我成了戰俘,心想這回這條命算是白扔了,兩頭都夠不着了。沒曾想我命大,居然沒死。於是我又產生了新的希望。停戰後遣返戰俘的時候,我說我在南朝鮮有親人,要求不回中國,也就把我留下了。 你找到他們了嗎? </s></s> 他們我是找到了,可是這邊我又回不來了。唉!</s>	sadness	sadness
<s> 不不,應該回來,應該回來!回來就好。這麼說韓先生是從景陽鎮參軍的了? 是的。 你走的時候家裏都有什麼人? 我的家裏就我老婆一個人,我們結婚不久。我還有一個弟弟跟我們一起過。我們老家兄弟三人,我行二,人稱我老兩。我還有一個哥哥和一個姐姐。我們到中國來的時候,我大哥和姐姐留在了朝鮮,就我和老三跟隨父母親過來了。父母親早就過世了。 你的三弟在哪兒? 我走的時候他在景陽鎮,現在不知道在哪兒。四十年了,他應該早就成家了。我這次回來就是爲了打聽我的妻子和三弟的消息,來看看他們。 只要他們還在,我們一定會幫你找到他們的,這你放心。我想,如果不發生什麼意外,他們也不會不在。 一晃四十年了。人這一輩子,也不過就這麼三、四十年的事,是悲是喜,是福是禍,往往就是一步之差。當年我參加志願軍不光是響應號召,也是想到朝鮮去看看我大哥和大姐。不想朝鮮分成了南北兩半,南北朝鮮兩個世界。他們是在南朝鮮,不但見不着面,連打聽都沒法打聽。後來我成了戰俘,心想這回這條命算是白扔了,兩頭都夠不着了。沒曾想我命大,居然沒死。於是我又產生了新的希望。停戰後遣返戰俘的時候,我說我在南朝鮮有親人,要求不回中國,也就把我留下了。 你找到他們了嗎? 他們我是找到了,可是這邊我又回不來了。唉! </s></s> 世道興衰,悲歡離合,古今中外都在所難免。不用說在兩個國家,就是在一個國家裏這種事也不少。現在好了,朝鮮不打仗了,中國也安定團結了,最近這幾年實行改革開放,出國旅遊,回國探親的越來越多。許多分別幾十年的親友都重新團聚了。韓先生既然回來了,就多住些日子。我回去就幫你找人。</s>	neutral	joy
<s> 是的。 你走的時候家裏都有什麼人? 我的家裏就我老婆一個人,我們結婚不久。我還有一個弟弟跟我們一起過。我們老家兄弟三人,我行二,人稱我老兩。我還有一個哥哥和一個姐姐。我們到中國來的時候,我大哥和姐姐留在了朝鮮,就我和老三跟隨父母親過來了。父母親早就過世了。 你的三弟在哪兒? 我走的時候他在景陽鎮,現在不知道在哪兒。四十年了,他應該早就成家了。我這次回來就是爲了打聽我的妻子和三弟的消息,來看看他們。 只要他們還在,我們一定會幫你找到他們的,這你放心。我想,如果不發生什麼意外,他們也不會不在。 一晃四十年了。人這一輩子,也不過就這麼三、四十年的事,是悲是喜,是福是禍,往往就是一步之差。當年我參加志願軍不光是響應號召,也是想到朝鮮去看看我大哥和大姐。不想朝鮮分成了南北兩半,南北朝鮮兩個世界。他們是在南朝鮮,不但見不着面,連打聽都沒法打聽。後來我成了戰俘,心想這回這條命算是白扔了,兩頭都夠不着了。沒曾想我命大,居然沒死。於是我又產生了新的希望。停戰後遣返戰俘的時候,我說我在南朝鮮有親人,要求不回中國,也就把我留下了。 你找到他們了嗎? 他們我是找到了,可是這邊我又回不來了。唉! 世道興衰,悲歡離合,古今中外都在所難免。不用說在兩個國家,就是在一個國家裏這種事也不少。現在好了,朝鮮不打仗了,中國也安定團結了,最近這幾年實行改革開放,出國旅遊,回國探親的越來越多。許多分別幾十年的親友都重新團聚了。韓先生既然回來了,就多住些日子。我回去就幫你找人。 </s></s> 那就拜託馬廠長了。我一回來就和鎮上的官員說我是回來探親的,可是不知道親人在哪裏。他們說可以幫助我找人。等我一提起過去的那些人那些事,他們根本就不知道。也難怪,那時候他們還是孩子,有的還沒出生呢。別說他們,連我自己都認不出地方了。這景陽鎮變化真是太大了。</s>	neutral	sadness
<s> 你走的時候家裏都有什麼人? 我的家裏就我老婆一個人,我們結婚不久。我還有一個弟弟跟我們一起過。我們老家兄弟三人,我行二,人稱我老兩。我還有一個哥哥和一個姐姐。我們到中國來的時候,我大哥和姐姐留在了朝鮮,就我和老三跟隨父母親過來了。父母親早就過世了。 你的三弟在哪兒? 我走的時候他在景陽鎮,現在不知道在哪兒。四十年了,他應該早就成家了。我這次回來就是爲了打聽我的妻子和三弟的消息,來看看他們。 只要他們還在,我們一定會幫你找到他們的,這你放心。我想,如果不發生什麼意外,他們也不會不在。 一晃四十年了。人這一輩子,也不過就這麼三、四十年的事,是悲是喜,是福是禍,往往就是一步之差。當年我參加志願軍不光是響應號召,也是想到朝鮮去看看我大哥和大姐。不想朝鮮分成了南北兩半,南北朝鮮兩個世界。他們是在南朝鮮,不但見不着面,連打聽都沒法打聽。後來我成了戰俘,心想這回這條命算是白扔了,兩頭都夠不着了。沒曾想我命大,居然沒死。於是我又產生了新的希望。停戰後遣返戰俘的時候,我說我在南朝鮮有親人,要求不回中國,也就把我留下了。 你找到他們了嗎? 他們我是找到了,可是這邊我又回不來了。唉! 世道興衰,悲歡離合,古今中外都在所難免。不用說在兩個國家,就是在一個國家裏這種事也不少。現在好了,朝鮮不打仗了,中國也安定團結了,最近這幾年實行改革開放,出國旅遊,回國探親的越來越多。許多分別幾十年的親友都重新團聚了。韓先生既然回來了,就多住些日子。我回去就幫你找人。 那就拜託馬廠長了。我一回來就和鎮上的官員說我是回來探親的,可是不知道親人在哪裏。他們說可以幫助我找人。等我一提起過去的那些人那些事,他們根本就不知道。也難怪,那時候他們還是孩子,有的還沒出生呢。別說他們,連我自己都認不出地方了。這景陽鎮變化真是太大了。 </s></s> 要說變化大主要還是改革開放這幾年,不光是經濟形勢變了,人的思想也變了。現在這些人活得多帶勁,跟咱們那時候可不一樣了。</s>	neutral	joy
<s> 我的家裏就我老婆一個人,我們結婚不久。我還有一個弟弟跟我們一起過。我們老家兄弟三人,我行二,人稱我老兩。我還有一個哥哥和一個姐姐。我們到中國來的時候,我大哥和姐姐留在了朝鮮,就我和老三跟隨父母親過來了。父母親早就過世了。 你的三弟在哪兒? 我走的時候他在景陽鎮,現在不知道在哪兒。四十年了,他應該早就成家了。我這次回來就是爲了打聽我的妻子和三弟的消息,來看看他們。 只要他們還在,我們一定會幫你找到他們的,這你放心。我想,如果不發生什麼意外,他們也不會不在。 一晃四十年了。人這一輩子,也不過就這麼三、四十年的事,是悲是喜,是福是禍,往往就是一步之差。當年我參加志願軍不光是響應號召,也是想到朝鮮去看看我大哥和大姐。不想朝鮮分成了南北兩半,南北朝鮮兩個世界。他們是在南朝鮮,不但見不着面,連打聽都沒法打聽。後來我成了戰俘,心想這回這條命算是白扔了,兩頭都夠不着了。沒曾想我命大,居然沒死。於是我又產生了新的希望。停戰後遣返戰俘的時候,我說我在南朝鮮有親人,要求不回中國,也就把我留下了。 你找到他們了嗎? 他們我是找到了,可是這邊我又回不來了。唉! 世道興衰,悲歡離合,古今中外都在所難免。不用說在兩個國家,就是在一個國家裏這種事也不少。現在好了,朝鮮不打仗了,中國也安定團結了,最近這幾年實行改革開放,出國旅遊,回國探親的越來越多。許多分別幾十年的親友都重新團聚了。韓先生既然回來了,就多住些日子。我回去就幫你找人。 那就拜託馬廠長了。我一回來就和鎮上的官員說我是回來探親的,可是不知道親人在哪裏。他們說可以幫助我找人。等我一提起過去的那些人那些事,他們根本就不知道。也難怪,那時候他們還是孩子,有的還沒出生呢。別說他們,連我自己都認不出地方了。這景陽鎮變化真是太大了。 要說變化大主要還是改革開放這幾年,不光是經濟形勢變了,人的思想也變了。現在這些人活得多帶勁,跟咱們那時候可不一樣了。 </s></s> 是呀!咱們活了這麼大年紀,吃苦受累一輩子,現在才趕上了好時代,過上了好日子,咱們也該好好活幾年了。</s>	neutral	joy
<s></s></s> 今天見到你就像見到親人一樣,我心裏實在高興。今天你就在這裏吃飯,咱們一塊喝兩盅,好好嘮嘮!</s>	joy	joy
<s> 今天見到你就像見到親人一樣,我心裏實在高興。今天你就在這裏吃飯,咱們一塊喝兩盅,好好嘮嘮! </s></s> 好,好啊!找人的事你放心,我會幫你找,鎮上也會幫你的。他們雖然年輕,可是認識的人多,辦法也多,一定能幫你找到。</s>	joy	joy
<s> 今天見到你就像見到親人一樣,我心裏實在高興。今天你就在這裏吃飯,咱們一塊喝兩盅,好好嘮嘮! 好,好啊!找人的事你放心,我會幫你找,鎮上也會幫你的。他們雖然年輕,可是認識的人多,辦法也多,一定能幫你找到。 </s></s> 放心,放心!</s>	joy	joy
<s></s></s> 喂......吳科長,我是小蘭,我在銀行呢。我家裏剛給我來了個電話,說家裏有點事讓我回去一下。我這就回去看看,明天一上班就回來......嗯,我一回來就接着查山西那筆錢,不會耽誤事的,你放心......噯,好的好的......吳科長,明天見!</s>	neutral	fear
<s> 喂......吳科長,我是小蘭,我在銀行呢。我家裏剛給我來了個電話,說家裏有點事讓我回去一下。我這就回去看看,明天一上班就回來......嗯,我一回來就接着查山西那筆錢,不會耽誤事的,你放心......噯,好的好的......吳科長,明天見! </s></s> 劉哥,先謝謝你!我得馬上回趟家,跟我媽要錢去。</s>	joy	joy
<s> 喂......吳科長,我是小蘭,我在銀行呢。我家裏剛給我來了個電話,說家裏有點事讓我回去一下。我這就回去看看,明天一上班就回來......嗯,我一回來就接着查山西那筆錢,不會耽誤事的,你放心......噯,好的好的......吳科長,明天見! 劉哥,先謝謝你!我得馬上回趟家,跟我媽要錢去。 </s></s> 別謝了,你快去吧!</s>	neutral	neutral
<s></s></s> 那個廠叫啥名來着?</s>	surprise	surprise
<s> 那個廠叫啥名來着? </s></s> 哈爾濱前進印刷廠。</s>	neutral	neutral
<s> 那個廠叫啥名來着? 哈爾濱前進印刷廠。 </s></s> 前進印刷廠?咱們光知道個廠名,上哪兒去找呀?</s>	surprise	surprise
<s> 那個廠叫啥名來着? 哈爾濱前進印刷廠。 前進印刷廠?咱們光知道個廠名,上哪兒去找呀? </s></s> 先上那個印刷器材公司去問問,說不定他們能知道。</s>	neutral	neutral
<s> 那個廠叫啥名來着? 哈爾濱前進印刷廠。 前進印刷廠?咱們光知道個廠名,上哪兒去找呀? 先上那個印刷器材公司去問問,說不定他們能知道。 </s></s> 他們要是不知道呢?</s>	fear	fear
<s> 那個廠叫啥名來着? 哈爾濱前進印刷廠。 前進印刷廠?咱們光知道個廠名,上哪兒去找呀? 先上那個印刷器材公司去問問,說不定他們能知道。 他們要是不知道呢? </s></s> 王總說了,上工商管理局去問一問就行,讓他們給查一下,一查就知道。</s>	neutral	neutral
<s> 那個廠叫啥名來着? 哈爾濱前進印刷廠。 前進印刷廠?咱們光知道個廠名,上哪兒去找呀? 先上那個印刷器材公司去問問,說不定他們能知道。 他們要是不知道呢? 王總說了,上工商管理局去問一問就行,讓他們給查一下,一查就知道。 </s></s> 哈爾濱那麼大,上哪兒找工商局去呀?</s>	surprise	surprise
<s> 那個廠叫啥名來着? 哈爾濱前進印刷廠。 前進印刷廠?咱們光知道個廠名,上哪兒去找呀? 先上那個印刷器材公司去問問,說不定他們能知道。 他們要是不知道呢? 王總說了,上工商管理局去問一問就行,讓他們給查一下,一查就知道。 哈爾濱那麼大,上哪兒找工商局去呀? </s></s> 不用上哈爾濱市工商局,在區的工商局就能查。</s>	neutral	neutral
<s> 那個廠叫啥名來着? 哈爾濱前進印刷廠。 前進印刷廠?咱們光知道個廠名,上哪兒去找呀? 先上那個印刷器材公司去問問,說不定他們能知道。 他們要是不知道呢? 王總說了,上工商管理局去問一問就行,讓他們給查一下,一查就知道。 哈爾濱那麼大,上哪兒找工商局去呀? 不用上哈爾濱市工商局,在區的工商局就能查。 </s></s> 人家要是不給查呢?</s>	fear	fear
<s> 那個廠叫啥名來着? 哈爾濱前進印刷廠。 前進印刷廠?咱們光知道個廠名,上哪兒去找呀? 先上那個印刷器材公司去問問,說不定他們能知道。 他們要是不知道呢? 王總說了,上工商管理局去問一問就行,讓他們給查一下,一查就知道。 哈爾濱那麼大,上哪兒找工商局去呀? 不用上哈爾濱市工商局,在區的工商局就能查。 人家要是不給查呢? </s></s> 那咱們就拿單位的介紹信去,他們會給查的。</s>	neutral	neutral
<s></s></s> 蔡科長,你好!</s>	joy	joy
<s> 蔡科長,你好! </s></s> 吆!你們兩個小姑娘怎麼又來了?我正想給你們打電話呢。</s>	surprise	surprise
<s> 蔡科長,你好! 吆!你們兩個小姑娘怎麼又來了?我正想給你們打電話呢。 </s></s> 我們來了,那就不用打電話了。</s>	joy	joy
<s> 蔡科長,你好! 吆!你們兩個小姑娘怎麼又來了?我正想給你們打電話呢。 我們來了,那就不用打電話了。 </s></s> 那好,我就把情況當面跟你們說說。我們查了一下,我們確實沒賣給你們機器,一臺也沒賣。所以這事跟我們就沒關係了。至於發票的事,我們是應該查一查,不是我們賣的機器爲什麼要用我們的發票?不過這種事過去也有過,</s>	angry	neutral
<s> 蔡科長,你好! 吆!你們兩個小姑娘怎麼又來了?我正想給你們打電話呢。 我們來了,那就不用打電話了。 那好,我就把情況當面跟你們說說。我們查了一下,我們確實沒賣給你們機器,一臺也沒賣。所以這事跟我們就沒關係了。至於發票的事,我們是應該查一查,不是我們賣的機器爲什麼要用我們的發票?不過這種事過去也有過, </s></s> 這麼說,那機器是前進印刷廠賣給我們的了?</s>	surprise	surprise
<s> 蔡科長,你好! 吆!你們兩個小姑娘怎麼又來了?我正想給你們打電話呢。 我們來了,那就不用打電話了。 那好,我就把情況當面跟你們說說。我們查了一下,我們確實沒賣給你們機器,一臺也沒賣。所以這事跟我們就沒關係了。至於發票的事,我們是應該查一查,不是我們賣的機器爲什麼要用我們的發票?不過這種事過去也有過, 這麼說,那機器是前進印刷廠賣給我們的了? </s></s> 哪個前進印刷廠?跟它有什麼關係?</s>	surprise	surprise
<s> 蔡科長,你好! 吆!你們兩個小姑娘怎麼又來了?我正想給你們打電話呢。 我們來了,那就不用打電話了。 那好,我就把情況當面跟你們說說。我們查了一下,我們確實沒賣給你們機器,一臺也沒賣。所以這事跟我們就沒關係了。至於發票的事,我們是應該查一查,不是我們賣的機器爲什麼要用我們的發票?不過這種事過去也有過, 這麼說,那機器是前進印刷廠賣給我們的了? 哪個前進印刷廠?跟它有什麼關係? </s></s> 到我們那幫助安裝機器的技師是前進印刷廠的。</s>	neutral	neutral
<s> 蔡科長,你好! 吆!你們兩個小姑娘怎麼又來了?我正想給你們打電話呢。 我們來了,那就不用打電話了。 那好,我就把情況當面跟你們說說。我們查了一下,我們確實沒賣給你們機器,一臺也沒賣。所以這事跟我們就沒關係了。至於發票的事,我們是應該查一查,不是我們賣的機器爲什麼要用我們的發票?不過這種事過去也有過, 這麼說,那機器是前進印刷廠賣給我們的了? 哪個前進印刷廠?跟它有什麼關係? 到我們那幫助安裝機器的技師是前進印刷廠的。 </s></s> 這樣的話,機器就應該是他們的。你們可以到那裏去問一下。</s>	neutral	neutral
<s> 蔡科長,你好! 吆!你們兩個小姑娘怎麼又來了?我正想給你們打電話呢。 我們來了,那就不用打電話了。 那好,我就把情況當面跟你們說說。我們查了一下,我們確實沒賣給你們機器,一臺也沒賣。所以這事跟我們就沒關係了。至於發票的事,我們是應該查一查,不是我們賣的機器爲什麼要用我們的發票?不過這種事過去也有過, 這麼說,那機器是前進印刷廠賣給我們的了? 哪個前進印刷廠?跟它有什麼關係? 到我們那幫助安裝機器的技師是前進印刷廠的。 這樣的話,機器就應該是他們的。你們可以到那裏去問一下。 </s></s> 前進印刷廠在哪兒?</s>	surprise	surprise
<s> 蔡科長,你好! 吆!你們兩個小姑娘怎麼又來了?我正想給你們打電話呢。 我們來了,那就不用打電話了。 那好,我就把情況當面跟你們說說。我們查了一下,我們確實沒賣給你們機器,一臺也沒賣。所以這事跟我們就沒關係了。至於發票的事,我們是應該查一查,不是我們賣的機器爲什麼要用我們的發票?不過這種事過去也有過, 這麼說,那機器是前進印刷廠賣給我們的了? 哪個前進印刷廠?跟它有什麼關係? 到我們那幫助安裝機器的技師是前進印刷廠的。 這樣的話,機器就應該是他們的。你們可以到那裏去問一下。 前進印刷廠在哪兒? </s></s> 我聽說過這個廠,在道外景陽街。</s>	neutral	neutral
<s> 蔡科長,你好! 吆!你們兩個小姑娘怎麼又來了?我正想給你們打電話呢。 我們來了,那就不用打電話了。 那好,我就把情況當面跟你們說說。我們查了一下,我們確實沒賣給你們機器,一臺也沒賣。所以這事跟我們就沒關係了。至於發票的事,我們是應該查一查,不是我們賣的機器爲什麼要用我們的發票?不過這種事過去也有過, 這麼說,那機器是前進印刷廠賣給我們的了? 哪個前進印刷廠?跟它有什麼關係? 到我們那幫助安裝機器的技師是前進印刷廠的。 這樣的話,機器就應該是他們的。你們可以到那裏去問一下。 前進印刷廠在哪兒? 我聽說過這個廠,在道外景陽街。 </s></s> 道外景陽街?</s>	surprise	surprise
<s> 吆!你們兩個小姑娘怎麼又來了?我正想給你們打電話呢。 我們來了,那就不用打電話了。 那好,我就把情況當面跟你們說說。我們查了一下,我們確實沒賣給你們機器,一臺也沒賣。所以這事跟我們就沒關係了。至於發票的事,我們是應該查一查,不是我們賣的機器爲什麼要用我們的發票?不過這種事過去也有過, 這麼說,那機器是前進印刷廠賣給我們的了? 哪個前進印刷廠?跟它有什麼關係? 到我們那幫助安裝機器的技師是前進印刷廠的。 這樣的話,機器就應該是他們的。你們可以到那裏去問一下。 前進印刷廠在哪兒? 我聽說過這個廠,在道外景陽街。 道外景陽街? </s></s> 對,過了鐵道就是道外區,不遠就是景陽街。</s>	neutral	neutral
<s></s></s> 還有什麼事嗎?</s>	surprise	surprise
<s> 還有什麼事嗎? </s></s> 沒有了,謝謝蔡科長。</s>	joy	joy
<s> 還有什麼事嗎? 沒有了,謝謝蔡科長。 </s></s> 不用謝,有問題可以再來。</s>	neutral	joy
<s></s></s> 咱們還上哪兒?</s>	surprise	surprise
<s> 咱們還上哪兒? </s></s> 上前進印刷廠吧。</s>	joy	neutral
<s> 咱們還上哪兒? 上前進印刷廠吧。 </s></s> 前進印刷廠在哪兒呀?</s>	surprise	surprise
<s> 咱們還上哪兒? 上前進印刷廠吧。 前進印刷廠在哪兒呀? </s></s> 蔡科長不是說在道外嗎?</s>	surprise	disgust
<s> 咱們還上哪兒? 上前進印刷廠吧。 前進印刷廠在哪兒呀? 蔡科長不是說在道外嗎? </s></s> 哪兒是道外呀?</s>	surprise	surprise
<s> 咱們還上哪兒? 上前進印刷廠吧。 前進印刷廠在哪兒呀? 蔡科長不是說在道外嗎? 哪兒是道外呀? </s></s> 他不是說過了鐵道就是道外嗎?</s>	surprise	angry
<s> 咱們還上哪兒? 上前進印刷廠吧。 前進印刷廠在哪兒呀? 蔡科長不是說在道外嗎? 哪兒是道外呀? 他不是說過了鐵道就是道外嗎? </s></s> 哈爾濱這地方真是的,叫個名也彆扭,啥道里道外的!</s>	disgust	disgust
<s> 咱們還上哪兒? 上前進印刷廠吧。 前進印刷廠在哪兒呀? 蔡科長不是說在道外嗎? 哪兒是道外呀? 他不是說過了鐵道就是道外嗎? 哈爾濱這地方真是的,叫個名也彆扭,啥道里道外的! </s></s> 記住了!道外區景陽街。</s>	neutral	neutral
<s> 咱們還上哪兒? 上前進印刷廠吧。 前進印刷廠在哪兒呀? 蔡科長不是說在道外嗎? 哪兒是道外呀? 他不是說過了鐵道就是道外嗎? 哈爾濱這地方真是的,叫個名也彆扭,啥道里道外的! 記住了!道外區景陽街。 </s></s> 景陽街,好記!跟景陽鎮一樣。</s>	joy	surprise
<s> 咱們還上哪兒? 上前進印刷廠吧。 前進印刷廠在哪兒呀? 蔡科長不是說在道外嗎? 哪兒是道外呀? 他不是說過了鐵道就是道外嗎? 哈爾濱這地方真是的,叫個名也彆扭,啥道里道外的! 記住了!道外區景陽街。 景陽街,好記!跟景陽鎮一樣。 </s></s> 走吧,過鐵道。</s>	neutral	neutral
<s> 咱們還上哪兒? 上前進印刷廠吧。 前進印刷廠在哪兒呀? 蔡科長不是說在道外嗎? 哪兒是道外呀? 他不是說過了鐵道就是道外嗎? 哈爾濱這地方真是的,叫個名也彆扭,啥道里道外的! 記住了!道外區景陽街。 景陽街,好記!跟景陽鎮一樣。 走吧,過鐵道。 </s></s> 鐵道在哪邊?</s>	surprise	surprise
<s> 上前進印刷廠吧。 前進印刷廠在哪兒呀? 蔡科長不是說在道外嗎? 哪兒是道外呀? 他不是說過了鐵道就是道外嗎? 哈爾濱這地方真是的,叫個名也彆扭,啥道里道外的! 記住了!道外區景陽街。 景陽街,好記!跟景陽鎮一樣。 走吧,過鐵道。 鐵道在哪邊? </s></s> 這邊!</s>	neutral	angry
<s> 前進印刷廠在哪兒呀? 蔡科長不是說在道外嗎? 哪兒是道外呀? 他不是說過了鐵道就是道外嗎? 哈爾濱這地方真是的,叫個名也彆扭,啥道里道外的! 記住了!道外區景陽街。 景陽街,好記!跟景陽鎮一樣。 走吧,過鐵道。 鐵道在哪邊? 這邊! </s></s> 咱們不坐車?</s>	surprise	surprise
<s> 蔡科長不是說在道外嗎? 哪兒是道外呀? 他不是說過了鐵道就是道外嗎? 哈爾濱這地方真是的,叫個名也彆扭,啥道里道外的! 記住了!道外區景陽街。 景陽街,好記!跟景陽鎮一樣。 走吧,過鐵道。 鐵道在哪邊? 這邊! 咱們不坐車? </s></s> 坐車更麻煩,也不知道是哪路車哪個站,走吧!</s>	neutral	neutral
<s></s></s> 到了!</s>	joy	surprise
<s> 到了! </s></s> 進去吧。</s>	neutral	neutral
<s></s></s> 怎麼辦?還調查啥呀?</s>	angry	fear
<s> 怎麼辦?還調查啥呀? </s></s> 他承認那機器是二手貨了,對不對?</s>	fear	surprise
<s> 怎麼辦?還調查啥呀? 他承認那機器是二手貨了,對不對? </s></s> 咱們花的錢不就是買二手貨的錢嗎?</s>	angry	surprise
<s> 怎麼辦?還調查啥呀? 他承認那機器是二手貨了,對不對? 咱們花的錢不就是買二手貨的錢嗎? </s></s> 二手貨也得是好的不能是廢的呀!那機器明明是不好用的嘛!</s>	disgust	angry
<s> 怎麼辦?還調查啥呀? 他承認那機器是二手貨了,對不對? 咱們花的錢不就是買二手貨的錢嗎? 二手貨也得是好的不能是廢的呀!那機器明明是不好用的嘛! </s></s> 就是馬廠長太貪便宜了,也可能是上人家的當了。</s>	sadness	neutral
<s> 怎麼辦?還調查啥呀? 他承認那機器是二手貨了,對不對? 咱們花的錢不就是買二手貨的錢嗎? 二手貨也得是好的不能是廢的呀!那機器明明是不好用的嘛! 就是馬廠長太貪便宜了,也可能是上人家的當了。 </s></s> 還有,小蘭說匯出去了了一百萬,可他咋說是七十六萬呢?給咱們的發票又是八十六萬,這到底是咋回事?</s>	surprise	surprise
<s> 怎麼辦?還調查啥呀? 他承認那機器是二手貨了,對不對? 咱們花的錢不就是買二手貨的錢嗎? 二手貨也得是好的不能是廢的呀!那機器明明是不好用的嘛! 就是馬廠長太貪便宜了,也可能是上人家的當了。 還有,小蘭說匯出去了了一百萬,可他咋說是七十六萬呢?給咱們的發票又是八十六萬,這到底是咋回事? </s></s> 那發票也不是他們的,是前邊那個公司的。</s>	neutral	neutral
<s> 怎麼辦?還調查啥呀? 他承認那機器是二手貨了,對不對? 咱們花的錢不就是買二手貨的錢嗎? 二手貨也得是好的不能是廢的呀!那機器明明是不好用的嘛! 就是馬廠長太貪便宜了,也可能是上人家的當了。 還有,小蘭說匯出去了了一百萬,可他咋說是七十六萬呢?給咱們的發票又是八十六萬,這到底是咋回事? 那發票也不是他們的,是前邊那個公司的。 </s></s> 可那個公司還說那發票不是他們開的。</s>	fear	fear
<s> 怎麼辦?還調查啥呀? 他承認那機器是二手貨了,對不對? 咱們花的錢不就是買二手貨的錢嗎? 二手貨也得是好的不能是廢的呀!那機器明明是不好用的嘛! 就是馬廠長太貪便宜了,也可能是上人家的當了。 還有,小蘭說匯出去了了一百萬,可他咋說是七十六萬呢?給咱們的發票又是八十六萬,這到底是咋回事? 那發票也不是他們的,是前邊那個公司的。 可那個公司還說那發票不是他們開的。 </s></s> 這裏肯定有貓兒匿!咋辦?還上哪調查?</s>	angry	fear
<s> 怎麼辦?還調查啥呀? 他承認那機器是二手貨了,對不對? 咱們花的錢不就是買二手貨的錢嗎? 二手貨也得是好的不能是廢的呀!那機器明明是不好用的嘛! 就是馬廠長太貪便宜了,也可能是上人家的當了。 還有,小蘭說匯出去了了一百萬,可他咋說是七十六萬呢?給咱們的發票又是八十六萬,這到底是咋回事? 那發票也不是他們的,是前邊那個公司的。 可那個公司還說那發票不是他們開的。 這裏肯定有貓兒匿!咋辦?還上哪調查? </s></s> 算了,不調查了,給局裏寫信,讓他們調查去!</s>	angry	disgust
<s></s></s> 這車是出租車嗎?</s>	surprise	surprise
<s> 這車是出租車嗎? </s></s> 是的,您要上哪兒?</s>	surprise	joy
<s> 這車是出租車嗎? 是的,您要上哪兒? </s></s> 這裏有個青河林場,你知道嗎?</s>	neutral	surprise
<s> 這車是出租車嗎? 是的,您要上哪兒? 這裏有個青河林場,你知道嗎? </s></s> 知道,我很熟。</s>	joy	joy
<s> 這車是出租車嗎? 是的,您要上哪兒? 這裏有個青河林場,你知道嗎? 知道,我很熟。 </s></s> 能去嗎?</s>	surprise	surprise
<s> 這車是出租車嗎? 是的,您要上哪兒? 這裏有個青河林場,你知道嗎? 知道,我很熟。 能去嗎? </s></s> 能去。</s>	neutral	joy
<s> 這車是出租車嗎? 是的,您要上哪兒? 這裏有個青河林場,你知道嗎? 知道,我很熟。 能去嗎? 能去。 </s></s> 多少錢?</s>	surprise	surprise
<s> 這車是出租車嗎? 是的,您要上哪兒? 這裏有個青河林場,你知道嗎? 知道,我很熟。 能去嗎? 能去。 多少錢? </s></s> 十五塊。</s>	neutral	neutral
<s> 這車是出租車嗎? 是的,您要上哪兒? 這裏有個青河林場,你知道嗎? 知道,我很熟。 能去嗎? 能去。 多少錢? 十五塊。 </s></s> 那裏不是通小火車嗎?</s>	surprise	surprise
<s> 這車是出租車嗎? 是的,您要上哪兒? 這裏有個青河林場,你知道嗎? 知道,我很熟。 能去嗎? 能去。 多少錢? 十五塊。 那裏不是通小火車嗎? </s></s> 通。</s>	neutral	neutral
<s> 這車是出租車嗎? 是的,您要上哪兒? 這裏有個青河林場,你知道嗎? 知道,我很熟。 能去嗎? 能去。 多少錢? 十五塊。 那裏不是通小火車嗎? 通。 </s></s> 坐小火車多少錢?</s>	surprise	surprise
<s> 是的,您要上哪兒? 這裏有個青河林場,你知道嗎? 知道,我很熟。 能去嗎? 能去。 多少錢? 十五塊。 那裏不是通小火車嗎? 通。 坐小火車多少錢? </s></s> 十塊</s>	neutral	neutral
<s> 這裏有個青河林場,你知道嗎? 知道,我很熟。 能去嗎? 能去。 多少錢? 十五塊。 那裏不是通小火車嗎? 通。 坐小火車多少錢? 十塊 </s></s> 小火車在哪兒上車?</s>	surprise	surprise
<s> 知道,我很熟。 能去嗎? 能去。 多少錢? 十五塊。 那裏不是通小火車嗎? 通。 坐小火車多少錢? 十塊 小火車在哪兒上車? </s></s> 小火車站,在那邊,大河邊上。</s>	joy	neutral
<s> 能去嗎? 能去。 多少錢? 十五塊。 那裏不是通小火車嗎? 通。 坐小火車多少錢? 十塊 小火車在哪兒上車? 小火車站,在那邊,大河邊上。 </s></s> 你拉我到小火車站吧,多少錢?</s>	joy	surprise
<s> 能去。 多少錢? 十五塊。 那裏不是通小火車嗎? 通。 坐小火車多少錢? 十塊 小火車在哪兒上車? 小火車站,在那邊,大河邊上。 你拉我到小火車站吧,多少錢? </s></s> 小火車一天就兩趟,這個時間沒車。</s>	joy	neutral
<s> 多少錢? 十五塊。 那裏不是通小火車嗎? 通。 坐小火車多少錢? 十塊 小火車在哪兒上車? 小火車站,在那邊,大河邊上。 你拉我到小火車站吧,多少錢? 小火車一天就兩趟,這個時間沒車。 </s></s> 那我就在那等唄,多少錢?</s>	joy	surprise
<s> 十五塊。 那裏不是通小火車嗎? 通。 坐小火車多少錢? 十塊 小火車在哪兒上車? 小火車站,在那邊,大河邊上。 你拉我到小火車站吧,多少錢? 小火車一天就兩趟,這個時間沒車。 那我就在那等唄,多少錢? </s></s> 到小火車站五塊錢。</s>	neutral	neutral
<s> 那裏不是通小火車嗎? 通。 坐小火車多少錢? 十塊 小火車在哪兒上車? 小火車站,在那邊,大河邊上。 你拉我到小火車站吧,多少錢? 小火車一天就兩趟,這個時間沒車。 那我就在那等唄,多少錢? 到小火車站五塊錢。 </s></s> 行,走吧。</s>	joy	neutral
<s></s></s> 師傅上青河是買木材吧?</s>	neutral	surprise
<s> 師傅上青河是買木材吧? </s></s> 是呀。</s>	joy	neutral
<s> 師傅上青河是買木材吧? 是呀。 </s></s> 坐過小火車嗎?</s>	surprise	surprise
<s> 師傅上青河是買木材吧? 是呀。 坐過小火車嗎? </s></s> 坐過。</s>	joy	neutral
<s> 師傅上青河是買木材吧? 是呀。 坐過小火車嗎? 坐過。 </s></s> 坐過了爲啥還要坐小火車呢?小火車也不比小汽車舒服。我把你直接拉到青河,才十五塊錢,十幾二十分鐘就到了,你坐小火車也得十五塊,現在還沒車,得等好幾個小時,你說哪個合算?</s>	surprise	surprise
<s> 師傅上青河是買木材吧? 是呀。 坐過小火車嗎? 坐過。 坐過了爲啥還要坐小火車呢?小火車也不比小汽車舒服。我把你直接拉到青河,才十五塊錢,十幾二十分鐘就到了,你坐小火車也得十五塊,現在還沒車,得等好幾個小時,你說哪個合算? </s></s> 倒也是啊,那就直接走吧!</s>	joy	joy
<s> 師傅上青河是買木材吧? 是呀。 坐過小火車嗎? 坐過。 坐過了爲啥還要坐小火車呢?小火車也不比小汽車舒服。我把你直接拉到青河,才十五塊錢,十幾二十分鐘就到了,你坐小火車也得十五塊,現在還沒車,得等好幾個小時,你說哪個合算? 倒也是啊,那就直接走吧! </s></s> 對嘛!到了青河,馬上聯繫業務,當天就可以返回鎮上。當天回不來,在青河住下也行,那裏有招待所有飯店,又方便又便宜。</s>	joy	joy
<s> 師傅上青河是買木材吧? 是呀。 坐過小火車嗎? 坐過。 坐過了爲啥還要坐小火車呢?小火車也不比小汽車舒服。我把你直接拉到青河,才十五塊錢,十幾二十分鐘就到了,你坐小火車也得十五塊,現在還沒車,得等好幾個小時,你說哪個合算? 倒也是啊,那就直接走吧! 對嘛!到了青河,馬上聯繫業務,當天就可以返回鎮上。當天回不來,在青河住下也行,那裏有招待所有飯店,又方便又便宜。 </s></s> 有道理,看來還是出租車方便。可是以前沒有出租車嘛。</s>	joy	joy
<s> 師傅上青河是買木材吧? 是呀。 坐過小火車嗎? 坐過。 坐過了爲啥還要坐小火車呢?小火車也不比小汽車舒服。我把你直接拉到青河,才十五塊錢,十幾二十分鐘就到了,你坐小火車也得十五塊,現在還沒車,得等好幾個小時,你說哪個合算? 倒也是啊,那就直接走吧! 對嘛!到了青河,馬上聯繫業務,當天就可以返回鎮上。當天回不來,在青河住下也行,那裏有招待所有飯店,又方便又便宜。 有道理,看來還是出租車方便。可是以前沒有出租車嘛。 </s></s> 以前沒有,現在不是有了嗎?</s>	surprise	joy
<s></s></s> 到了,你在這個公司就能買木材。</s>	joy	joy
<s> 到了,你在這個公司就能買木材。 </s></s> 好,謝謝你,給你錢。</s>	joy	joy
<s> 到了,你在這個公司就能買木材。 好,謝謝你,給你錢。 </s></s> 不用謝,你去談吧。我也不馬上走,你要回去,我可以把你捎回去。</s>	neutral	joy
<s> 到了,你在這個公司就能買木材。 好,謝謝你,給你錢。 不用謝,你去談吧。我也不馬上走,你要回去,我可以把你捎回去。 </s></s> 太好了!那就請你等一下。</s>	joy	joy
<s> 到了,你在這個公司就能買木材。 好,謝謝你,給你錢。 不用謝,你去談吧。我也不馬上走,你要回去,我可以把你捎回去。 太好了!那就請你等一下。 </s></s> 沒事兒。</s>	neutral	joy
<s></s></s> 小夥子,你還在這等呢嗎?</s>	surprise	surprise
<s> 小夥子,你還在這等呢嗎? </s></s> 是呀,你回去嗎?</s>	surprise	surprise
<s> 小夥子,你還在這等呢嗎? 是呀,你回去嗎? </s></s> 我不回去了,明天就要裝車,我就住這兒了。</s>	neutral	neutral
<s> 小夥子,你還在這等呢嗎? 是呀,你回去嗎? 我不回去了,明天就要裝車,我就住這兒了。 </s></s> 這跟前就有招待所,很方便。</s>	joy	joy
<s> 小夥子,你還在這等呢嗎? 是呀,你回去嗎? 我不回去了,明天就要裝車,我就住這兒了。 這跟前就有招待所,很方便。 </s></s> 那你只好自個兒回去了。</s>	neutral	neutral
<s> 小夥子,你還在這等呢嗎? 是呀,你回去嗎? 我不回去了,明天就要裝車,我就住這兒了。 這跟前就有招待所,很方便。 那你只好自個兒回去了。 </s></s> 沒關係,我可以到小火車站那兒去拉客。</s>	joy	joy
<s> 小夥子,你還在這等呢嗎? 是呀,你回去嗎? 我不回去了,明天就要裝車,我就住這兒了。 這跟前就有招待所,很方便。 那你只好自個兒回去了。 沒關係,我可以到小火車站那兒去拉客。 </s></s> 謝謝你!</s>	joy	joy
<s> 小夥子,你還在這等呢嗎? 是呀,你回去嗎? 我不回去了,明天就要裝車,我就住這兒了。 這跟前就有招待所,很方便。 那你只好自個兒回去了。 沒關係,我可以到小火車站那兒去拉客。 謝謝你! </s></s> 不客氣。</s>	joy	joy
<s></s></s> 你就踏踏實實幹你的公司吧!</s>	joy	joy
<s> 你就踏踏實實幹你的公司吧! </s></s> 對。</s>	neutral	joy
<s></s></s> 哥!</s>	surprise	surprise
<s> 哥! </s></s> 你不上班跑到這來幹啥?</s>	surprise	surprise
<s> 哥! 你不上班跑到這來幹啥? </s></s> 給我點錢!</s>	angry	surprise
<s> 哥! 你不上班跑到這來幹啥? 給我點錢! </s></s> 給你點錢?</s>	surprise	surprise
<s> 哥! 你不上班跑到這來幹啥? 給我點錢! 給你點錢? </s></s> 嗯。</s>	neutral	neutral
<s> 哥! 你不上班跑到這來幹啥? 給我點錢! 給你點錢? 嗯。 </s></s> 你自己沒錢嗎?你都工作了!</s>	angry	disgust
<s> 哥! 你不上班跑到這來幹啥? 給我點錢! 給你點錢? 嗯。 你自己沒錢嗎?你都工作了! </s></s> 臨時用。</s>	neutral	neutral
<s> 哥! 你不上班跑到這來幹啥? 給我點錢! 給你點錢? 嗯。 你自己沒錢嗎?你都工作了! 臨時用。 </s></s> 啥臨時不臨時?你不是月月都發工資嗎?</s>	surprise	disgust
<s> 哥! 你不上班跑到這來幹啥? 給我點錢! 給你點錢? 嗯。 你自己沒錢嗎?你都工作了! 臨時用。 啥臨時不臨時?你不是月月都發工資嗎? </s></s> 發的工資不是都給媽交了嗎?</s>	angry	sadness
<s> 哥! 你不上班跑到這來幹啥? 給我點錢! 給你點錢? 嗯。 你自己沒錢嗎?你都工作了! 臨時用。 啥臨時不臨時?你不是月月都發工資嗎? 發的工資不是都給媽交了嗎? </s></s> 都交了嗎?我不信你就一點都沒留。</s>	angry	disgust
<s> 哥! 你不上班跑到這來幹啥? 給我點錢! 給你點錢? 嗯。 你自己沒錢嗎?你都工作了! 臨時用。 啥臨時不臨時?你不是月月都發工資嗎? 發的工資不是都給媽交了嗎? 都交了嗎?我不信你就一點都沒留。 </s></s> 留是留了一點兒,那夠幹啥的?</s>	angry	disgust
<s> 你不上班跑到這來幹啥? 給我點錢! 給你點錢? 嗯。 你自己沒錢嗎?你都工作了! 臨時用。 啥臨時不臨時?你不是月月都發工資嗎? 發的工資不是都給媽交了嗎? 都交了嗎?我不信你就一點都沒留。 留是留了一點兒,那夠幹啥的? </s></s> 不夠?你要買啥?</s>	surprise	surprise
<s> 給我點錢! 給你點錢? 嗯。 你自己沒錢嗎?你都工作了! 臨時用。 啥臨時不臨時?你不是月月都發工資嗎? 發的工資不是都給媽交了嗎? 都交了嗎?我不信你就一點都沒留。 留是留了一點兒,那夠幹啥的? 不夠?你要買啥? </s></s> 不買東西。</s>	neutral	neutral
<s> 給你點錢? 嗯。 你自己沒錢嗎?你都工作了! 臨時用。 啥臨時不臨時?你不是月月都發工資嗎? 發的工資不是都給媽交了嗎? 都交了嗎?我不信你就一點都沒留。 留是留了一點兒,那夠幹啥的? 不夠?你要買啥? 不買東西。 </s></s> 不買東西你要錢幹啥?</s>	angry	surprise
<s> 嗯。 你自己沒錢嗎?你都工作了! 臨時用。 啥臨時不臨時?你不是月月都發工資嗎? 發的工資不是都給媽交了嗎? 都交了嗎?我不信你就一點都沒留。 留是留了一點兒,那夠幹啥的? 不夠?你要買啥? 不買東西。 不買東西你要錢幹啥? </s></s> 別問了行不行?</s>	angry	disgust
<s> 你自己沒錢嗎?你都工作了! 臨時用。 啥臨時不臨時?你不是月月都發工資嗎? 發的工資不是都給媽交了嗎? 都交了嗎?我不信你就一點都沒留。 留是留了一點兒,那夠幹啥的? 不夠?你要買啥? 不買東西。 不買東西你要錢幹啥? 別問了行不行? </s></s> 不行!想要錢還不說幹啥用?</s>	angry	angry
<s> 臨時用。 啥臨時不臨時?你不是月月都發工資嗎? 發的工資不是都給媽交了嗎? 都交了嗎?我不信你就一點都沒留。 留是留了一點兒,那夠幹啥的? 不夠?你要買啥? 不買東西。 不買東西你要錢幹啥? 別問了行不行? 不行!想要錢還不說幹啥用? </s></s> 不要,借!還不行嗎?</s>	angry	angry
<s> 啥臨時不臨時?你不是月月都發工資嗎? 發的工資不是都給媽交了嗎? 都交了嗎?我不信你就一點都沒留。 留是留了一點兒,那夠幹啥的? 不夠?你要買啥? 不買東西。 不買東西你要錢幹啥? 別問了行不行? 不行!想要錢還不說幹啥用? 不要,借!還不行嗎? </s></s> 行,你要借多少?</s>	angry	surprise
<s></s></s> 爸要是在家咋辦呀?</s>	fear	fear
<s> 爸要是在家咋辦呀? </s></s> 你先進屋看看,爸要在家就把媽叫出來說。</s>	fear	neutral
<s> 爸要是在家咋辦呀? 你先進屋看看,爸要在家就把媽叫出來說。 </s></s> 好吧。</s>	neutral	fear
<s></s></s> 劉哥!你們也剛上班吧?</s>	surprise	surprise
<s> 劉哥!你們也剛上班吧? </s></s> 是呀,你回家了嗎?這麼快就回來了?</s>	surprise	surprise
<s> 劉哥!你們也剛上班吧? 是呀,你回家了嗎?這麼快就回來了? </s></s> 不快點不行,銀行一開門我就得進去,趕在別人前面。</s>	joy	fear
<s> 劉哥!你們也剛上班吧? 是呀,你回家了嗎?這麼快就回來了? 不快點不行,銀行一開門我就得進去,趕在別人前面。 </s></s> 錢湊齊了嗎?</s>	surprise	surprise
<s> 劉哥!你們也剛上班吧? 是呀,你回家了嗎?這麼快就回來了? 不快點不行,銀行一開門我就得進去,趕在別人前面。 錢湊齊了嗎? </s></s> 我把我媽的存摺要來了,裏邊也沒多少錢。你跟她們借了嗎?</s>	surprise	surprise
<s> 劉哥!你們也剛上班吧? 是呀,你回家了嗎?這麼快就回來了? 不快點不行,銀行一開門我就得進去,趕在別人前面。 錢湊齊了嗎? 我把我媽的存摺要來了,裏邊也沒多少錢。你跟她們借了嗎? </s></s> 我跟東俄商店那兩個姑娘說了,她們給湊了三萬,我這裏有一萬五,總共四萬五,還差五千塊錢。</s>	neutral	neutral
<s> 劉哥!你們也剛上班吧? 是呀,你回家了嗎?這麼快就回來了? 不快點不行,銀行一開門我就得進去,趕在別人前面。 錢湊齊了嗎? 我把我媽的存摺要來了,裏邊也沒多少錢。你跟她們借了嗎? 我跟東俄商店那兩個姑娘說了,她們給湊了三萬,我這裏有一萬五,總共四萬五,還差五千塊錢。 </s></s> 太好了,劉哥!我就知道你有辦法。謝謝你!太謝謝你了!</s>	joy	joy
<s> 劉哥!你們也剛上班吧? 是呀,你回家了嗎?這麼快就回來了? 不快點不行,銀行一開門我就得進去,趕在別人前面。 錢湊齊了嗎? 我把我媽的存摺要來了,裏邊也沒多少錢。你跟她們借了嗎? 我跟東俄商店那兩個姑娘說了,她們給湊了三萬,我這裏有一萬五,總共四萬五,還差五千塊錢。 太好了,劉哥!我就知道你有辦法。謝謝你!太謝謝你了! </s></s> 先不用謝,那五千塊錢怎麼辦?我這裏可就剩下吃飯的錢了。</s>	fear	fear
<s> 劉哥!你們也剛上班吧? 是呀,你回家了嗎?這麼快就回來了? 不快點不行,銀行一開門我就得進去,趕在別人前面。 錢湊齊了嗎? 我把我媽的存摺要來了,裏邊也沒多少錢。你跟她們借了嗎? 我跟東俄商店那兩個姑娘說了,她們給湊了三萬,我這裏有一萬五,總共四萬五,還差五千塊錢。 太好了,劉哥!我就知道你有辦法。謝謝你!太謝謝你了! 先不用謝,那五千塊錢怎麼辦?我這裏可就剩下吃飯的錢了。 </s></s> “沒關係,大數解決了,剩下的就好辦了。</s>	joy	joy
<s></s></s> 這是四萬五千塊,你點一下。</s>	neutral	neutral
<s> 這是四萬五千塊,你點一下。 </s></s> 我不點了,讓銀行他們點去吧。</s>	neutral	surprise
<s> 這是四萬五千塊,你點一下。 我不點了,讓銀行他們點去吧。 </s></s> 剩下那五千塊錢我得過幾天還你。</s>	neutral	fear
<s> 這是四萬五千塊,你點一下。 我不點了,讓銀行他們點去吧。 剩下那五千塊錢我得過幾天還你。 </s></s> 不用了,我媽的存折上還能取出五千,這就夠了。</s>	joy	joy
<s> 這是四萬五千塊,你點一下。 我不點了,讓銀行他們點去吧。 剩下那五千塊錢我得過幾天還你。 不用了,我媽的存折上還能取出五千,這就夠了。 </s></s> 還有,小蘭,我跟你說,我找人家姑娘救急,人家幫了我,我得給人家利息,這不能含糊。你這邊怎麼辦?我不能兩邊付利息呀,是不是?</s>	fear	fear
<s> 這是四萬五千塊,你點一下。 我不點了,讓銀行他們點去吧。 剩下那五千塊錢我得過幾天還你。 不用了,我媽的存折上還能取出五千,這就夠了。 還有,小蘭,我跟你說,我找人家姑娘救急,人家幫了我,我得給人家利息,這不能含糊。你這邊怎麼辦?我不能兩邊付利息呀,是不是? </s></s> 哎呀!這回是你幫我了,我感謝你還來不及呢,還什麼利息呀!</s>	surprise	joy
<s> 這是四萬五千塊,你點一下。 我不點了,讓銀行他們點去吧。 剩下那五千塊錢我得過幾天還你。 不用了,我媽的存折上還能取出五千,這就夠了。 還有,小蘭,我跟你說,我找人家姑娘救急,人家幫了我,我得給人家利息,這不能含糊。你這邊怎麼辦?我不能兩邊付利息呀,是不是? 哎呀!這回是你幫我了,我感謝你還來不及呢,還什麼利息呀! </s></s> 那就好。</s>	joy	joy
<s> 這是四萬五千塊,你點一下。 我不點了,讓銀行他們點去吧。 剩下那五千塊錢我得過幾天還你。 不用了,我媽的存折上還能取出五千,這就夠了。 還有,小蘭,我跟你說,我找人家姑娘救急,人家幫了我,我得給人家利息,這不能含糊。你這邊怎麼辦?我不能兩邊付利息呀,是不是? 哎呀!這回是你幫我了,我感謝你還來不及呢,還什麼利息呀! 那就好。 </s></s> 我走了!</s>	neutral	joy
<s> 這是四萬五千塊,你點一下。 我不點了,讓銀行他們點去吧。 剩下那五千塊錢我得過幾天還你。 不用了,我媽的存折上還能取出五千,這就夠了。 還有,小蘭,我跟你說,我找人家姑娘救急,人家幫了我,我得給人家利息,這不能含糊。你這邊怎麼辦?我不能兩邊付利息呀,是不是? 哎呀!這回是你幫我了,我感謝你還來不及呢,還什麼利息呀! 那就好。 我走了! </s></s> 走吧,你小心點!</s>	fear	fear
<s> 這是四萬五千塊,你點一下。 我不點了,讓銀行他們點去吧。 剩下那五千塊錢我得過幾天還你。 不用了,我媽的存折上還能取出五千,這就夠了。 還有,小蘭,我跟你說,我找人家姑娘救急,人家幫了我,我得給人家利息,這不能含糊。你這邊怎麼辦?我不能兩邊付利息呀,是不是? 哎呀!這回是你幫我了,我感謝你還來不及呢,還什麼利息呀! 那就好。 我走了! 走吧,你小心點! </s></s> 哎。</s>	fear	joy
<s></s></s> 現金是四萬五,再從這個摺子裏取五千,總共五萬,都存到林業局這個帳戶裏。</s>	neutral	neutral
<s> 現金是四萬五,再從這個摺子裏取五千,總共五萬,都存到林業局這個帳戶裏。 </s></s> 小蘭,你來得挺早!</s>	joy	surprise
<s> 現金是四萬五,再從這個摺子裏取五千,總共五萬,都存到林業局這個帳戶裏。 小蘭,你來得挺早! </s></s> 德富!你咋來了?</s>	surprise	surprise
<s> 現金是四萬五,再從這個摺子裏取五千,總共五萬,都存到林業局這個帳戶裏。 小蘭,你來得挺早! 德富!你咋來了? </s></s> 我來查一下山西那筆錢,昨天科長不是讓咱們查一下嗎?</s>	neutral	neutral
<s> 現金是四萬五,再從這個摺子裏取五千,總共五萬,都存到林業局這個帳戶裏。 小蘭,你來得挺早! 德富!你咋來了? 我來查一下山西那筆錢,昨天科長不是讓咱們查一下嗎? </s></s> 噢,那筆錢呀,我昨天查過了,有!沒事了,你回去吧。</s>	neutral	surprise
<s> 現金是四萬五,再從這個摺子裏取五千,總共五萬,都存到林業局這個帳戶裏。 小蘭,你來得挺早! 德富!你咋來了? 我來查一下山西那筆錢,昨天科長不是讓咱們查一下嗎? 噢,那筆錢呀,我昨天查過了,有!沒事了,你回去吧。 </s></s> 查過了?那就好,我就不用再查了。</s>	joy	surprise
<s> 現金是四萬五,再從這個摺子裏取五千,總共五萬,都存到林業局這個帳戶裏。 小蘭,你來得挺早! 德富!你咋來了? 我來查一下山西那筆錢,昨天科長不是讓咱們查一下嗎? 噢,那筆錢呀,我昨天查過了,有!沒事了,你回去吧。 查過了?那就好,我就不用再查了。 </s></s> 對,查過了,沒錯,你回去吧。</s>	neutral	fear
<s></s></s> 噯,好。</s>	joy	neutral
<s> 噯,好。 </s></s> 我先走了。你給誰存錢?</s>	neutral	surprise
<s> 噯,好。 我先走了。你給誰存錢? </s></s> 替林場存的,我昨天回青河去了一趟,他們讓我順便給存一筆錢。你先走吧,我馬上就回去。</s>	neutral	fear
<s></s></s> 這筆錢咱們帳上怎麼沒有?銀行進帳了嗎?</s>	surprise	surprise
<s> 這筆錢咱們帳上怎麼沒有?銀行進帳了嗎? </s></s> 銀行肯定進帳了,咱們沒有進帳單,所以沒上帳。</s>	sadness	fear
<s> 這筆錢咱們帳上怎麼沒有?銀行進帳了嗎? 銀行肯定進帳了,咱們沒有進帳單,所以沒上帳。 </s></s> 怎麼會沒有進帳單呢?奇怪!</s>	surprise	surprise
<s> 這筆錢咱們帳上怎麼沒有?銀行進帳了嗎? 銀行肯定進帳了,咱們沒有進帳單,所以沒上帳。 怎麼會沒有進帳單呢?奇怪! </s></s> 這筆錢他們要用就給他們支出去算了,咱們也不用作帳了。</s>	neutral	fear
<s> 這筆錢咱們帳上怎麼沒有?銀行進帳了嗎? 銀行肯定進帳了,咱們沒有進帳單,所以沒上帳。 怎麼會沒有進帳單呢?奇怪! 這筆錢他們要用就給他們支出去算了,咱們也不用作帳了。 </s></s> 那可不行,咱們帳上應該有記錄才行。</s>	joy	disgust
<s></s></s> 請坐。老馬,王升那五十萬有頭緒了嗎?</s>	neutral	surprise
<s> 請坐。老馬,王升那五十萬有頭緒了嗎? </s></s> 還沒有?</s>	surprise	surprise
<s> 請坐。老馬,王升那五十萬有頭緒了嗎? 還沒有? </s></s> 沒向公安局報案嗎?</s>	surprise	surprise
<s> 請坐。老馬,王升那五十萬有頭緒了嗎? 還沒有? 沒向公安局報案嗎? </s></s> 報了,當時就報了。</s>	neutral	angry
<s> 請坐。老馬,王升那五十萬有頭緒了嗎? 還沒有? 沒向公安局報案嗎? 報了,當時就報了。 </s></s> 他們立案了嗎?</s>	surprise	surprise
<s> 請坐。老馬,王升那五十萬有頭緒了嗎? 還沒有? 沒向公安局報案嗎? 報了,當時就報了。 他們立案了嗎? </s></s> 應該立案了。不過這種案子不好破,有的抓不到人,抓到人了錢也追不回來。錢一弄到手,他們立刻就轉移了。都是些要錢不要命的,你別想讓他們把錢吐出來。</s>	neutral	angry
<s> 請坐。老馬,王升那五十萬有頭緒了嗎? 還沒有? 沒向公安局報案嗎? 報了,當時就報了。 他們立案了嗎? 應該立案了。不過這種案子不好破,有的抓不到人,抓到人了錢也追不回來。錢一弄到手,他們立刻就轉移了。都是些要錢不要命的,你別想讓他們把錢吐出來。 </s></s> 王升在縣城遇到了一個什麼公司,說是專門經營進口鋼材的,有一千噸鋼絲要出手,價格便宜,還給送貨。王升說機會難得,要把這一千噸都買下來,開口就要二百五十萬。我說我沒那麼多錢,先少買一點,買二百噸,給了他五十萬。看來我幸虧沒答應他,要都給他就都得給人騙走。</s>	neutral	angry
<s> 請坐。老馬,王升那五十萬有頭緒了嗎? 還沒有? 沒向公安局報案嗎? 報了,當時就報了。 他們立案了嗎? 應該立案了。不過這種案子不好破,有的抓不到人,抓到人了錢也追不回來。錢一弄到手,他們立刻就轉移了。都是些要錢不要命的,你別想讓他們把錢吐出來。 王升在縣城遇到了一個什麼公司,說是專門經營進口鋼材的,有一千噸鋼絲要出手,價格便宜,還給送貨。王升說機會難得,要把這一千噸都買下來,開口就要二百五十萬。我說我沒那麼多錢,先少買一點,買二百噸,給了他五十萬。看來我幸虧沒答應他,要都給他就都得給人騙走。 </s></s> 他也跟我要過,我手里根本沒錢。</s>	sadness	neutral
<s> 請坐。老馬,王升那五十萬有頭緒了嗎? 還沒有? 沒向公安局報案嗎? 報了,當時就報了。 他們立案了嗎? 應該立案了。不過這種案子不好破,有的抓不到人,抓到人了錢也追不回來。錢一弄到手,他們立刻就轉移了。都是些要錢不要命的,你別想讓他們把錢吐出來。 王升在縣城遇到了一個什麼公司,說是專門經營進口鋼材的,有一千噸鋼絲要出手,價格便宜,還給送貨。王升說機會難得,要把這一千噸都買下來,開口就要二百五十萬。我說我沒那麼多錢,先少買一點,買二百噸,給了他五十萬。看來我幸虧沒答應他,要都給他就都得給人騙走。 他也跟我要過,我手里根本沒錢。 </s></s> 你沒答應他就對了。聽說他還帶着歌廳小姐上酒店開房?他說的那個什麼公司老闆,很可能就是在歌廳酒店那裏認識的。</s>	neutral	disgust
<s> 請坐。老馬,王升那五十萬有頭緒了嗎? 還沒有? 沒向公安局報案嗎? 報了,當時就報了。 他們立案了嗎? 應該立案了。不過這種案子不好破,有的抓不到人,抓到人了錢也追不回來。錢一弄到手,他們立刻就轉移了。都是些要錢不要命的,你別想讓他們把錢吐出來。 王升在縣城遇到了一個什麼公司,說是專門經營進口鋼材的,有一千噸鋼絲要出手,價格便宜,還給送貨。王升說機會難得,要把這一千噸都買下來,開口就要二百五十萬。我說我沒那麼多錢,先少買一點,買二百噸,給了他五十萬。看來我幸虧沒答應他,要都給他就都得給人騙走。 他也跟我要過,我手里根本沒錢。 你沒答應他就對了。聽說他還帶着歌廳小姐上酒店開房?他說的那個什麼公司老闆,很可能就是在歌廳酒店那裏認識的。 </s></s> 我不知道。</s>	neutral	neutral
<s> 請坐。老馬,王升那五十萬有頭緒了嗎? 還沒有? 沒向公安局報案嗎? 報了,當時就報了。 他們立案了嗎? 應該立案了。不過這種案子不好破,有的抓不到人,抓到人了錢也追不回來。錢一弄到手,他們立刻就轉移了。都是些要錢不要命的,你別想讓他們把錢吐出來。 王升在縣城遇到了一個什麼公司,說是專門經營進口鋼材的,有一千噸鋼絲要出手,價格便宜,還給送貨。王升說機會難得,要把這一千噸都買下來,開口就要二百五十萬。我說我沒那麼多錢,先少買一點,買二百噸,給了他五十萬。看來我幸虧沒答應他,要都給他就都得給人騙走。 他也跟我要過,我手里根本沒錢。 你沒答應他就對了。聽說他還帶着歌廳小姐上酒店開房?他說的那個什麼公司老闆,很可能就是在歌廳酒店那裏認識的。 我不知道。 </s></s> 別忘了,你是當過組織部長的,現在當了總經理也不能不管人哪。不是一到了大集體,組織紀律就沒有了,就不管用了。黨員是什麼樣還得是什麼樣,還得遵守紀律。就是一般羣衆還有法律管着呢,不是開放了就可以無法無天了。</s>	neutral	disgust
<s> 還沒有? 沒向公安局報案嗎? 報了,當時就報了。 他們立案了嗎? 應該立案了。不過這種案子不好破,有的抓不到人,抓到人了錢也追不回來。錢一弄到手,他們立刻就轉移了。都是些要錢不要命的,你別想讓他們把錢吐出來。 王升在縣城遇到了一個什麼公司,說是專門經營進口鋼材的,有一千噸鋼絲要出手,價格便宜,還給送貨。王升說機會難得,要把這一千噸都買下來,開口就要二百五十萬。我說我沒那麼多錢,先少買一點,買二百噸,給了他五十萬。看來我幸虧沒答應他,要都給他就都得給人騙走。 他也跟我要過,我手里根本沒錢。 你沒答應他就對了。聽說他還帶着歌廳小姐上酒店開房?他說的那個什麼公司老闆,很可能就是在歌廳酒店那裏認識的。 我不知道。 別忘了,你是當過組織部長的,現在當了總經理也不能不管人哪。不是一到了大集體,組織紀律就沒有了,就不管用了。黨員是什麼樣還得是什麼樣,還得遵守紀律。就是一般羣衆還有法律管着呢,不是開放了就可以無法無天了。 </s></s> 王升的情況我瞭解一些,以前他也有過男女關係的問題,最近的情況不太瞭解。</s>	neutral	disgust
<s> 沒向公安局報案嗎? 報了,當時就報了。 他們立案了嗎? 應該立案了。不過這種案子不好破,有的抓不到人,抓到人了錢也追不回來。錢一弄到手,他們立刻就轉移了。都是些要錢不要命的,你別想讓他們把錢吐出來。 王升在縣城遇到了一個什麼公司,說是專門經營進口鋼材的,有一千噸鋼絲要出手,價格便宜,還給送貨。王升說機會難得,要把這一千噸都買下來,開口就要二百五十萬。我說我沒那麼多錢,先少買一點,買二百噸,給了他五十萬。看來我幸虧沒答應他,要都給他就都得給人騙走。 他也跟我要過,我手里根本沒錢。 你沒答應他就對了。聽說他還帶着歌廳小姐上酒店開房?他說的那個什麼公司老闆,很可能就是在歌廳酒店那裏認識的。 我不知道。 別忘了,你是當過組織部長的,現在當了總經理也不能不管人哪。不是一到了大集體,組織紀律就沒有了,就不管用了。黨員是什麼樣還得是什麼樣,還得遵守紀律。就是一般羣衆還有法律管着呢,不是開放了就可以無法無天了。 王升的情況我瞭解一些,以前他也有過男女關係的問題,最近的情況不太瞭解。 </s></s> 男女關係絕不僅僅是作風問題。以前把它當作作風問題來處理,現在看來就不那麼簡單了。作風問題勢必發展爲腐敗。王升的問題一定要嚴肅處理。要以他爲戒,在勞動服務公司開展組織紀律方面的教育,堵住口子,避免經濟問題和生活問題氾濫。</s>	neutral	disgust
<s> 報了,當時就報了。 他們立案了嗎? 應該立案了。不過這種案子不好破,有的抓不到人,抓到人了錢也追不回來。錢一弄到手,他們立刻就轉移了。都是些要錢不要命的,你別想讓他們把錢吐出來。 王升在縣城遇到了一個什麼公司,說是專門經營進口鋼材的,有一千噸鋼絲要出手,價格便宜,還給送貨。王升說機會難得,要把這一千噸都買下來,開口就要二百五十萬。我說我沒那麼多錢,先少買一點,買二百噸,給了他五十萬。看來我幸虧沒答應他,要都給他就都得給人騙走。 他也跟我要過,我手里根本沒錢。 你沒答應他就對了。聽說他還帶着歌廳小姐上酒店開房?他說的那個什麼公司老闆,很可能就是在歌廳酒店那裏認識的。 我不知道。 別忘了,你是當過組織部長的,現在當了總經理也不能不管人哪。不是一到了大集體,組織紀律就沒有了,就不管用了。黨員是什麼樣還得是什麼樣,還得遵守紀律。就是一般羣衆還有法律管着呢,不是開放了就可以無法無天了。 王升的情況我瞭解一些,以前他也有過男女關係的問題,最近的情況不太瞭解。 男女關係絕不僅僅是作風問題。以前把它當作作風問題來處理,現在看來就不那麼簡單了。作風問題勢必發展爲腐敗。王升的問題一定要嚴肅處理。要以他爲戒,在勞動服務公司開展組織紀律方面的教育,堵住口子,避免經濟問題和生活問題氾濫。 </s></s> 好的,我一定照辦。</s>	neutral	neutral
<s> 他們立案了嗎? 應該立案了。不過這種案子不好破,有的抓不到人,抓到人了錢也追不回來。錢一弄到手,他們立刻就轉移了。都是些要錢不要命的,你別想讓他們把錢吐出來。 王升在縣城遇到了一個什麼公司,說是專門經營進口鋼材的,有一千噸鋼絲要出手,價格便宜,還給送貨。王升說機會難得,要把這一千噸都買下來,開口就要二百五十萬。我說我沒那麼多錢,先少買一點,買二百噸,給了他五十萬。看來我幸虧沒答應他,要都給他就都得給人騙走。 他也跟我要過,我手里根本沒錢。 你沒答應他就對了。聽說他還帶着歌廳小姐上酒店開房?他說的那個什麼公司老闆,很可能就是在歌廳酒店那裏認識的。 我不知道。 別忘了,你是當過組織部長的,現在當了總經理也不能不管人哪。不是一到了大集體,組織紀律就沒有了,就不管用了。黨員是什麼樣還得是什麼樣,還得遵守紀律。就是一般羣衆還有法律管着呢,不是開放了就可以無法無天了。 王升的情況我瞭解一些,以前他也有過男女關係的問題,最近的情況不太瞭解。 男女關係絕不僅僅是作風問題。以前把它當作作風問題來處理,現在看來就不那麼簡單了。作風問題勢必發展爲腐敗。王升的問題一定要嚴肅處理。要以他爲戒,在勞動服務公司開展組織紀律方面的教育,堵住口子,避免經濟問題和生活問題氾濫。 好的,我一定照辦。 </s></s> 對王升的具體處理意見你們先考慮一下,拿個意見上來。他那個金屬製品公司還沒投產吧?</s>	neutral	surprise
<s> 應該立案了。不過這種案子不好破,有的抓不到人,抓到人了錢也追不回來。錢一弄到手,他們立刻就轉移了。都是些要錢不要命的,你別想讓他們把錢吐出來。 王升在縣城遇到了一個什麼公司,說是專門經營進口鋼材的,有一千噸鋼絲要出手,價格便宜,還給送貨。王升說機會難得,要把這一千噸都買下來,開口就要二百五十萬。我說我沒那麼多錢,先少買一點,買二百噸,給了他五十萬。看來我幸虧沒答應他,要都給他就都得給人騙走。 他也跟我要過,我手里根本沒錢。 你沒答應他就對了。聽說他還帶着歌廳小姐上酒店開房?他說的那個什麼公司老闆,很可能就是在歌廳酒店那裏認識的。 我不知道。 別忘了,你是當過組織部長的,現在當了總經理也不能不管人哪。不是一到了大集體,組織紀律就沒有了,就不管用了。黨員是什麼樣還得是什麼樣,還得遵守紀律。就是一般羣衆還有法律管着呢,不是開放了就可以無法無天了。 王升的情況我瞭解一些,以前他也有過男女關係的問題,最近的情況不太瞭解。 男女關係絕不僅僅是作風問題。以前把它當作作風問題來處理,現在看來就不那麼簡單了。作風問題勢必發展爲腐敗。王升的問題一定要嚴肅處理。要以他爲戒,在勞動服務公司開展組織紀律方面的教育,堵住口子,避免經濟問題和生活問題氾濫。 好的,我一定照辦。 對王升的具體處理意見你們先考慮一下,拿個意見上來。他那個金屬製品公司還沒投產吧? </s></s> 還沒有。</s>	neutral	neutral
<s> 王升在縣城遇到了一個什麼公司,說是專門經營進口鋼材的,有一千噸鋼絲要出手,價格便宜,還給送貨。王升說機會難得,要把這一千噸都買下來,開口就要二百五十萬。我說我沒那麼多錢,先少買一點,買二百噸,給了他五十萬。看來我幸虧沒答應他,要都給他就都得給人騙走。 他也跟我要過,我手里根本沒錢。 你沒答應他就對了。聽說他還帶着歌廳小姐上酒店開房?他說的那個什麼公司老闆,很可能就是在歌廳酒店那裏認識的。 我不知道。 別忘了,你是當過組織部長的,現在當了總經理也不能不管人哪。不是一到了大集體,組織紀律就沒有了,就不管用了。黨員是什麼樣還得是什麼樣,還得遵守紀律。就是一般羣衆還有法律管着呢,不是開放了就可以無法無天了。 王升的情況我瞭解一些,以前他也有過男女關係的問題,最近的情況不太瞭解。 男女關係絕不僅僅是作風問題。以前把它當作作風問題來處理,現在看來就不那麼簡單了。作風問題勢必發展爲腐敗。王升的問題一定要嚴肅處理。要以他爲戒,在勞動服務公司開展組織紀律方面的教育,堵住口子,避免經濟問題和生活問題氾濫。 好的,我一定照辦。 對王升的具體處理意見你們先考慮一下,拿個意見上來。他那個金屬製品公司還沒投產吧? 還沒有。 </s></s> 讓他負責那個公司是我們決策的一個失誤。王升不是沒有能力。可是他的心思不在正道上。他追求的是享樂。金屬公司是勞動服務公司的骨幹企業,讓王升給耽誤了。你再物色一個人過去,讓金屬加工廠儘快投產。發展三產也是需要精兵強將的。這個負責人可以在集體那邊找,也可以在全民這邊找,你要誰就給你調誰。</s>	disgust	neutral
<s> 他也跟我要過,我手里根本沒錢。 你沒答應他就對了。聽說他還帶着歌廳小姐上酒店開房?他說的那個什麼公司老闆,很可能就是在歌廳酒店那裏認識的。 我不知道。 別忘了,你是當過組織部長的,現在當了總經理也不能不管人哪。不是一到了大集體,組織紀律就沒有了,就不管用了。黨員是什麼樣還得是什麼樣,還得遵守紀律。就是一般羣衆還有法律管着呢,不是開放了就可以無法無天了。 王升的情況我瞭解一些,以前他也有過男女關係的問題,最近的情況不太瞭解。 男女關係絕不僅僅是作風問題。以前把它當作作風問題來處理,現在看來就不那麼簡單了。作風問題勢必發展爲腐敗。王升的問題一定要嚴肅處理。要以他爲戒,在勞動服務公司開展組織紀律方面的教育,堵住口子,避免經濟問題和生活問題氾濫。 好的,我一定照辦。 對王升的具體處理意見你們先考慮一下,拿個意見上來。他那個金屬製品公司還沒投產吧? 還沒有。 讓他負責那個公司是我們決策的一個失誤。王升不是沒有能力。可是他的心思不在正道上。他追求的是享樂。金屬公司是勞動服務公司的骨幹企業,讓王升給耽誤了。你再物色一個人過去,讓金屬加工廠儘快投產。發展三產也是需要精兵強將的。這個負責人可以在集體那邊找,也可以在全民這邊找,你要誰就給你調誰。 </s></s> 好的。</s>	neutral	neutral
<s> 你沒答應他就對了。聽說他還帶着歌廳小姐上酒店開房?他說的那個什麼公司老闆,很可能就是在歌廳酒店那裏認識的。 我不知道。 別忘了,你是當過組織部長的,現在當了總經理也不能不管人哪。不是一到了大集體,組織紀律就沒有了,就不管用了。黨員是什麼樣還得是什麼樣,還得遵守紀律。就是一般羣衆還有法律管着呢,不是開放了就可以無法無天了。 王升的情況我瞭解一些,以前他也有過男女關係的問題,最近的情況不太瞭解。 男女關係絕不僅僅是作風問題。以前把它當作作風問題來處理,現在看來就不那麼簡單了。作風問題勢必發展爲腐敗。王升的問題一定要嚴肅處理。要以他爲戒,在勞動服務公司開展組織紀律方面的教育,堵住口子,避免經濟問題和生活問題氾濫。 好的,我一定照辦。 對王升的具體處理意見你們先考慮一下,拿個意見上來。他那個金屬製品公司還沒投產吧? 還沒有。 讓他負責那個公司是我們決策的一個失誤。王升不是沒有能力。可是他的心思不在正道上。他追求的是享樂。金屬公司是勞動服務公司的骨幹企業,讓王升給耽誤了。你再物色一個人過去,讓金屬加工廠儘快投產。發展三產也是需要精兵強將的。這個負責人可以在集體那邊找,也可以在全民這邊找,你要誰就給你調誰。 好的。 </s></s> 那你先去忙吧,我們再談點別的事。</s>	neutral	neutral
<s> 我不知道。 別忘了,你是當過組織部長的,現在當了總經理也不能不管人哪。不是一到了大集體,組織紀律就沒有了,就不管用了。黨員是什麼樣還得是什麼樣,還得遵守紀律。就是一般羣衆還有法律管着呢,不是開放了就可以無法無天了。 王升的情況我瞭解一些,以前他也有過男女關係的問題,最近的情況不太瞭解。 男女關係絕不僅僅是作風問題。以前把它當作作風問題來處理,現在看來就不那麼簡單了。作風問題勢必發展爲腐敗。王升的問題一定要嚴肅處理。要以他爲戒,在勞動服務公司開展組織紀律方面的教育,堵住口子,避免經濟問題和生活問題氾濫。 好的,我一定照辦。 對王升的具體處理意見你們先考慮一下,拿個意見上來。他那個金屬製品公司還沒投產吧? 還沒有。 讓他負責那個公司是我們決策的一個失誤。王升不是沒有能力。可是他的心思不在正道上。他追求的是享樂。金屬公司是勞動服務公司的骨幹企業,讓王升給耽誤了。你再物色一個人過去,讓金屬加工廠儘快投產。發展三產也是需要精兵強將的。這個負責人可以在集體那邊找,也可以在全民這邊找,你要誰就給你調誰。 好的。 那你先去忙吧,我們再談點別的事。 </s></s> 好的。</s>	neutral	neutral
<s></s></s> 吳科長,有人寫匿名信舉報,說印刷廠馬軍在節前採購印刷機的過程中有違紀行爲。你們財務上有什麼反映嗎?</s>	surprise	surprise
<s> 吳科長,有人寫匿名信舉報,說印刷廠馬軍在節前採購印刷機的過程中有違紀行爲。你們財務上有什麼反映嗎? </s></s> 他採購印刷機從財務上借走了一百萬,機器買來了,花了八十六萬,剩下的十四萬他一直沒還,現在還掛在帳上。</s>	neutral	angry
<s> 吳科長,有人寫匿名信舉報,說印刷廠馬軍在節前採購印刷機的過程中有違紀行爲。你們財務上有什麼反映嗎? 他採購印刷機從財務上借走了一百萬,機器買來了,花了八十六萬,剩下的十四萬他一直沒還,現在還掛在帳上。 </s></s> 他爲什麼不還?</s>	surprise	angry
<s> 吳科長,有人寫匿名信舉報,說印刷廠馬軍在節前採購印刷機的過程中有違紀行爲。你們財務上有什麼反映嗎? 他採購印刷機從財務上借走了一百萬,機器買來了,花了八十六萬,剩下的十四萬他一直沒還,現在還掛在帳上。 他爲什麼不還? </s></s> 他說事情還沒辦完,錢還有用。</s>	neutral	angry
<s> 吳科長,有人寫匿名信舉報,說印刷廠馬軍在節前採購印刷機的過程中有違紀行爲。你們財務上有什麼反映嗎? 他採購印刷機從財務上借走了一百萬,機器買來了,花了八十六萬,剩下的十四萬他一直沒還,現在還掛在帳上。 他爲什麼不還? 他說事情還沒辦完,錢還有用。 </s></s> 這就是問題,該報就得報,餘款應該交回,要用了下次再借嘛。舉報人說,他買來的是二手機,根本不好用,給退回去了。來安裝機器的不是賣給我們機器那個單位的技師,是另外找來的人,這是怎麼回事?本來我們買機器是爲國慶節出專刊的,要彩色套印,結果沒印成,還是在人家的印刷廠裏印的。你看他這個事情辦的!</s>	angry	angry
<s> 吳科長,有人寫匿名信舉報,說印刷廠馬軍在節前採購印刷機的過程中有違紀行爲。你們財務上有什麼反映嗎? 他採購印刷機從財務上借走了一百萬,機器買來了,花了八十六萬,剩下的十四萬他一直沒還,現在還掛在帳上。 他爲什麼不還? 他說事情還沒辦完,錢還有用。 這就是問題,該報就得報,餘款應該交回,要用了下次再借嘛。舉報人說,他買來的是二手機,根本不好用,給退回去了。來安裝機器的不是賣給我們機器那個單位的技師,是另外找來的人,這是怎麼回事?本來我們買機器是爲國慶節出專刊的,要彩色套印,結果沒印成,還是在人家的印刷廠裏印的。你看他這個事情辦的! </s></s> 這方面的事我們也聽到一些反映。</s>	neutral	fear
<s> 吳科長,有人寫匿名信舉報,說印刷廠馬軍在節前採購印刷機的過程中有違紀行爲。你們財務上有什麼反映嗎? 他採購印刷機從財務上借走了一百萬,機器買來了,花了八十六萬,剩下的十四萬他一直沒還,現在還掛在帳上。 他爲什麼不還? 他說事情還沒辦完,錢還有用。 這就是問題,該報就得報,餘款應該交回,要用了下次再借嘛。舉報人說,他買來的是二手機,根本不好用,給退回去了。來安裝機器的不是賣給我們機器那個單位的技師,是另外找來的人,這是怎麼回事?本來我們買機器是爲國慶節出專刊的,要彩色套印,結果沒印成,還是在人家的印刷廠裏印的。你看他這個事情辦的! 這方面的事我們也聽到一些反映。 </s></s> 你們去調查一下,經濟方面和機器質量都有什麼問題。如果真有問題,局裏要成立專案組立案調查。剩餘款項姜科長你通知他立即歸還。</s>	neutral	angry
<s> 吳科長,有人寫匿名信舉報,說印刷廠馬軍在節前採購印刷機的過程中有違紀行爲。你們財務上有什麼反映嗎? 他採購印刷機從財務上借走了一百萬,機器買來了,花了八十六萬,剩下的十四萬他一直沒還,現在還掛在帳上。 他爲什麼不還? 他說事情還沒辦完,錢還有用。 這就是問題,該報就得報,餘款應該交回,要用了下次再借嘛。舉報人說,他買來的是二手機,根本不好用,給退回去了。來安裝機器的不是賣給我們機器那個單位的技師,是另外找來的人,這是怎麼回事?本來我們買機器是爲國慶節出專刊的,要彩色套印,結果沒印成,還是在人家的印刷廠裏印的。你看他這個事情辦的! 這方面的事我們也聽到一些反映。 你們去調查一下,經濟方面和機器質量都有什麼問題。如果真有問題,局裏要成立專案組立案調查。剩餘款項姜科長你通知他立即歸還。 </s></s> 好吧。。</s>	neutral	neutral
<s> 吳科長,有人寫匿名信舉報,說印刷廠馬軍在節前採購印刷機的過程中有違紀行爲。你們財務上有什麼反映嗎? 他採購印刷機從財務上借走了一百萬,機器買來了,花了八十六萬,剩下的十四萬他一直沒還,現在還掛在帳上。 他爲什麼不還? 他說事情還沒辦完,錢還有用。 這就是問題,該報就得報,餘款應該交回,要用了下次再借嘛。舉報人說,他買來的是二手機,根本不好用,給退回去了。來安裝機器的不是賣給我們機器那個單位的技師,是另外找來的人,這是怎麼回事?本來我們買機器是爲國慶節出專刊的,要彩色套印,結果沒印成,還是在人家的印刷廠裏印的。你看他這個事情辦的! 這方面的事我們也聽到一些反映。 你們去調查一下,經濟方面和機器質量都有什麼問題。如果真有問題,局裏要成立專案組立案調查。剩餘款項姜科長你通知他立即歸還。 好吧。。 </s></s> 我們馬上就去調查。</s>	neutral	surprise
<s></s></s> 白主任嗎?我是老馬,馬洪偉,你好!......老白呀,有件事你幫我辦一下......你給我查一下檔案,查一下一個工人的情況......他叫韓長林,韓國的韓,長短的長,森林的林,韓長林,五十年代在咱們加工廠當過工人......你查一下,他當時家裏都有什麼人,叫什麼名字,現在這些人還在不在,在啥地方......哎,對,對......好,我等你的電話。</s>	neutral	joy
<s> 白主任嗎?我是老馬,馬洪偉,你好!......老白呀,有件事你幫我辦一下......你給我查一下檔案,查一下一個工人的情況......他叫韓長林,韓國的韓,長短的長,森林的林,韓長林,五十年代在咱們加工廠當過工人......你查一下,他當時家裏都有什麼人,叫什麼名字,現在這些人還在不在,在啥地方......哎,對,對......好,我等你的電話。 </s></s> 爸,鎮上叫你去幹啥呀?</s>	surprise	surprise
<s> 白主任嗎?我是老馬,馬洪偉,你好!......老白呀,有件事你幫我辦一下......你給我查一下檔案,查一下一個工人的情況......他叫韓長林,韓國的韓,長短的長,森林的林,韓長林,五十年代在咱們加工廠當過工人......你查一下,他當時家裏都有什麼人,叫什麼名字,現在這些人還在不在,在啥地方......哎,對,對......好,我等你的電話。 爸,鎮上叫你去幹啥呀? </s></s> 有個韓國來的外賓,住在景陽賓館。這個外賓還是老景陽鎮的人,他認識我,鎮上就把我叫去了。外賓要打聽他老家的人。他們讓我幫忙找一下。</s>	neutral	joy
<s> 白主任嗎?我是老馬,馬洪偉,你好!......老白呀,有件事你幫我辦一下......你給我查一下檔案,查一下一個工人的情況......他叫韓長林,韓國的韓,長短的長,森林的林,韓長林,五十年代在咱們加工廠當過工人......你查一下,他當時家裏都有什麼人,叫什麼名字,現在這些人還在不在,在啥地方......哎,對,對......好,我等你的電話。 爸,鎮上叫你去幹啥呀? 有個韓國來的外賓,住在景陽賓館。這個外賓還是老景陽鎮的人,他認識我,鎮上就把我叫去了。外賓要打聽他老家的人。他們讓我幫忙找一下。 </s></s> 老景陽鎮的人?景陽鎮的人還成外賓了?</s>	surprise	surprise
<s> 白主任嗎?我是老馬,馬洪偉,你好!......老白呀,有件事你幫我辦一下......你給我查一下檔案,查一下一個工人的情況......他叫韓長林,韓國的韓,長短的長,森林的林,韓長林,五十年代在咱們加工廠當過工人......你查一下,他當時家裏都有什麼人,叫什麼名字,現在這些人還在不在,在啥地方......哎,對,對......好,我等你的電話。 爸,鎮上叫你去幹啥呀? 有個韓國來的外賓,住在景陽賓館。這個外賓還是老景陽鎮的人,他認識我,鎮上就把我叫去了。外賓要打聽他老家的人。他們讓我幫忙找一下。 老景陽鎮的人?景陽鎮的人還成外賓了? </s></s> 那咋不行?人家老早就走了,出國了,在外國定居了,這回是從外國來的,還不就是外賓?</s>	surprise	surprise
<s> 白主任嗎?我是老馬,馬洪偉,你好!......老白呀,有件事你幫我辦一下......你給我查一下檔案,查一下一個工人的情況......他叫韓長林,韓國的韓,長短的長,森林的林,韓長林,五十年代在咱們加工廠當過工人......你查一下,他當時家裏都有什麼人,叫什麼名字,現在這些人還在不在,在啥地方......哎,對,對......好,我等你的電話。 爸,鎮上叫你去幹啥呀? 有個韓國來的外賓,住在景陽賓館。這個外賓還是老景陽鎮的人,他認識我,鎮上就把我叫去了。外賓要打聽他老家的人。他們讓我幫忙找一下。 老景陽鎮的人?景陽鎮的人還成外賓了? 那咋不行?人家老早就走了,出國了,在外國定居了,這回是從外國來的,還不就是外賓? </s></s> 他是老景陽鎮的還不知道自己家里人的情況?</s>	surprise	surprise
<s> 白主任嗎?我是老馬,馬洪偉,你好!......老白呀,有件事你幫我辦一下......你給我查一下檔案,查一下一個工人的情況......他叫韓長林,韓國的韓,長短的長,森林的林,韓長林,五十年代在咱們加工廠當過工人......你查一下,他當時家裏都有什麼人,叫什麼名字,現在這些人還在不在,在啥地方......哎,對,對......好,我等你的電話。 爸,鎮上叫你去幹啥呀? 有個韓國來的外賓,住在景陽賓館。這個外賓還是老景陽鎮的人,他認識我,鎮上就把我叫去了。外賓要打聽他老家的人。他們讓我幫忙找一下。 老景陽鎮的人?景陽鎮的人還成外賓了? 那咋不行?人家老早就走了,出國了,在外國定居了,這回是從外國來的,還不就是外賓? 他是老景陽鎮的還不知道自己家里人的情況? </s></s> 他咋能知道?這都多少年了?四十年了!他走的時候才二十來歲,現在六十多了,他住的房子早就沒了。</s>	surprise	sadness
<s> 白主任嗎?我是老馬,馬洪偉,你好!......老白呀,有件事你幫我辦一下......你給我查一下檔案,查一下一個工人的情況......他叫韓長林,韓國的韓,長短的長,森林的林,韓長林,五十年代在咱們加工廠當過工人......你查一下,他當時家裏都有什麼人,叫什麼名字,現在這些人還在不在,在啥地方......哎,對,對......好,我等你的電話。 爸,鎮上叫你去幹啥呀? 有個韓國來的外賓,住在景陽賓館。這個外賓還是老景陽鎮的人,他認識我,鎮上就把我叫去了。外賓要打聽他老家的人。他們讓我幫忙找一下。 老景陽鎮的人?景陽鎮的人還成外賓了? 那咋不行?人家老早就走了,出國了,在外國定居了,這回是從外國來的,還不就是外賓? 他是老景陽鎮的還不知道自己家里人的情況? 他咋能知道?這都多少年了?四十年了!他走的時候才二十來歲,現在六十多了,他住的房子早就沒了。 </s></s> 你認識他嗎?</s>	surprise	surprise
<s> 白主任嗎?我是老馬,馬洪偉,你好!......老白呀,有件事你幫我辦一下......你給我查一下檔案,查一下一個工人的情況......他叫韓長林,韓國的韓,長短的長,森林的林,韓長林,五十年代在咱們加工廠當過工人......你查一下,他當時家裏都有什麼人,叫什麼名字,現在這些人還在不在,在啥地方......哎,對,對......好,我等你的電話。 爸,鎮上叫你去幹啥呀? 有個韓國來的外賓,住在景陽賓館。這個外賓還是老景陽鎮的人,他認識我,鎮上就把我叫去了。外賓要打聽他老家的人。他們讓我幫忙找一下。 老景陽鎮的人?景陽鎮的人還成外賓了? 那咋不行?人家老早就走了,出國了,在外國定居了,這回是從外國來的,還不就是外賓? 他是老景陽鎮的還不知道自己家里人的情況? 他咋能知道?這都多少年了?四十年了!他走的時候才二十來歲,現在六十多了,他住的房子早就沒了。 你認識他嗎? </s></s> 他說他在加工廠當過工人,還知道我是廠長。我可是想不起來了。</s>	neutral	neutral
<s> 白主任嗎?我是老馬,馬洪偉,你好!......老白呀,有件事你幫我辦一下......你給我查一下檔案,查一下一個工人的情況......他叫韓長林,韓國的韓,長短的長,森林的林,韓長林,五十年代在咱們加工廠當過工人......你查一下,他當時家裏都有什麼人,叫什麼名字,現在這些人還在不在,在啥地方......哎,對,對......好,我等你的電話。 爸,鎮上叫你去幹啥呀? 有個韓國來的外賓,住在景陽賓館。這個外賓還是老景陽鎮的人,他認識我,鎮上就把我叫去了。外賓要打聽他老家的人。他們讓我幫忙找一下。 老景陽鎮的人?景陽鎮的人還成外賓了? 那咋不行?人家老早就走了,出國了,在外國定居了,這回是從外國來的,還不就是外賓? 他是老景陽鎮的還不知道自己家里人的情況? 他咋能知道?這都多少年了?四十年了!他走的時候才二十來歲,現在六十多了,他住的房子早就沒了。 你認識他嗎? 他說他在加工廠當過工人,還知道我是廠長。我可是想不起來了。 </s></s> 他叫啥名兒?</s>	surprise	surprise
<s> 白主任嗎?我是老馬,馬洪偉,你好!......老白呀,有件事你幫我辦一下......你給我查一下檔案,查一下一個工人的情況......他叫韓長林,韓國的韓,長短的長,森林的林,韓長林,五十年代在咱們加工廠當過工人......你查一下,他當時家裏都有什麼人,叫什麼名字,現在這些人還在不在,在啥地方......哎,對,對......好,我等你的電話。 爸,鎮上叫你去幹啥呀? 有個韓國來的外賓,住在景陽賓館。這個外賓還是老景陽鎮的人,他認識我,鎮上就把我叫去了。外賓要打聽他老家的人。他們讓我幫忙找一下。 老景陽鎮的人?景陽鎮的人還成外賓了? 那咋不行?人家老早就走了,出國了,在外國定居了,這回是從外國來的,還不就是外賓? 他是老景陽鎮的還不知道自己家里人的情況? 他咋能知道?這都多少年了?四十年了!他走的時候才二十來歲,現在六十多了,他住的房子早就沒了。 你認識他嗎? 他說他在加工廠當過工人,還知道我是廠長。我可是想不起來了。 他叫啥名兒? </s></s> 他叫韓長林,那時候都叫他韓老兩,他是他們家老二。</s>	neutral	neutral
<s> 爸,鎮上叫你去幹啥呀? 有個韓國來的外賓,住在景陽賓館。這個外賓還是老景陽鎮的人,他認識我,鎮上就把我叫去了。外賓要打聽他老家的人。他們讓我幫忙找一下。 老景陽鎮的人?景陽鎮的人還成外賓了? 那咋不行?人家老早就走了,出國了,在外國定居了,這回是從外國來的,還不就是外賓? 他是老景陽鎮的還不知道自己家里人的情況? 他咋能知道?這都多少年了?四十年了!他走的時候才二十來歲,現在六十多了,他住的房子早就沒了。 你認識他嗎? 他說他在加工廠當過工人,還知道我是廠長。我可是想不起來了。 他叫啥名兒? 他叫韓長林,那時候都叫他韓老兩,他是他們家老二。 </s></s> 韓長林?韓老兩?沒聽說過。他要找的人叫啥名兒?</s>	surprise	surprise
<s></s></s> 白主任嗎?......查了?五十年代初期根本沒有檔案......哦,後來的檔案裏沒有這個人,哦......可以到派出所去查一下......對......好,好......謝謝你,白主任,再見。</s>	neutral	surprise
<s> 白主任嗎?......查了?五十年代初期根本沒有檔案......哦,後來的檔案裏沒有這個人,哦......可以到派出所去查一下......對......好,好......謝謝你,白主任,再見。 </s></s> 查到了?</s>	surprise	surprise
<s> 白主任嗎?......查了?五十年代初期根本沒有檔案......哦,後來的檔案裏沒有這個人,哦......可以到派出所去查一下......對......好,好......謝謝你,白主任,再見。 查到了? </s></s> 白主任說,五十年代初期沒有檔案。不對,檔案是有的,可能後來給銷毀了。後來的檔案裏沒這個人。可不是嗎,後來的檔案裏怎麼會有他呢?</s>	surprise	surprise
<s> 白主任嗎?......查了?五十年代初期根本沒有檔案......哦,後來的檔案裏沒有這個人,哦......可以到派出所去查一下......對......好,好......謝謝你,白主任,再見。 查到了? 白主任說,五十年代初期沒有檔案。不對,檔案是有的,可能後來給銷毀了。後來的檔案裏沒這個人。可不是嗎,後來的檔案裏怎麼會有他呢? </s></s> 他要是景陽鎮的老人,也用不着查檔案,問問老人就知道了。他叫啥名兒?</s>	neutral	surprise
<s> 白主任嗎?......查了?五十年代初期根本沒有檔案......哦,後來的檔案裏沒有這個人,哦......可以到派出所去查一下......對......好,好......謝謝你,白主任,再見。 查到了? 白主任說,五十年代初期沒有檔案。不對,檔案是有的,可能後來給銷毀了。後來的檔案裏沒這個人。可不是嗎,後來的檔案裏怎麼會有他呢? 他要是景陽鎮的老人,也用不着查檔案,問問老人就知道了。他叫啥名兒? </s></s> 他叫韓長林,韓老兩,他要找他的弟弟。</s>	neutral	neutral
<s> 白主任嗎?......查了?五十年代初期根本沒有檔案......哦,後來的檔案裏沒有這個人,哦......可以到派出所去查一下......對......好,好......謝謝你,白主任,再見。 查到了? 白主任說,五十年代初期沒有檔案。不對,檔案是有的,可能後來給銷毀了。後來的檔案裏沒這個人。可不是嗎,後來的檔案裏怎麼會有他呢? 他要是景陽鎮的老人,也用不着查檔案,問問老人就知道了。他叫啥名兒? 他叫韓長林,韓老兩,他要找他的弟弟。 </s></s> 他弟弟叫啥名兒?</s>	surprise	surprise
<s> 白主任嗎?......查了?五十年代初期根本沒有檔案......哦,後來的檔案裏沒有這個人,哦......可以到派出所去查一下......對......好,好......謝謝你,白主任,再見。 查到了? 白主任說,五十年代初期沒有檔案。不對,檔案是有的,可能後來給銷毀了。後來的檔案裏沒這個人。可不是嗎,後來的檔案裏怎麼會有他呢? 他要是景陽鎮的老人,也用不着查檔案,問問老人就知道了。他叫啥名兒? 他叫韓長林,韓老兩,他要找他的弟弟。 他弟弟叫啥名兒? </s></s> 他弟弟叫——韓長——韓長波!</s>	neutral	joy
<s> 白主任嗎?......查了?五十年代初期根本沒有檔案......哦,後來的檔案裏沒有這個人,哦......可以到派出所去查一下......對......好,好......謝謝你,白主任,再見。 查到了? 白主任說,五十年代初期沒有檔案。不對,檔案是有的,可能後來給銷毀了。後來的檔案裏沒這個人。可不是嗎,後來的檔案裏怎麼會有他呢? 他要是景陽鎮的老人,也用不着查檔案,問問老人就知道了。他叫啥名兒? 他叫韓長林,韓老兩,他要找他的弟弟。 他弟弟叫啥名兒? 他弟弟叫——韓長——韓長波! </s></s> 啥?韓長波?</s>	surprise	surprise
<s> 白主任嗎?......查了?五十年代初期根本沒有檔案......哦,後來的檔案裏沒有這個人,哦......可以到派出所去查一下......對......好,好......謝謝你,白主任,再見。 查到了? 白主任說,五十年代初期沒有檔案。不對,檔案是有的,可能後來給銷毀了。後來的檔案裏沒這個人。可不是嗎,後來的檔案裏怎麼會有他呢? 他要是景陽鎮的老人,也用不着查檔案,問問老人就知道了。他叫啥名兒? 他叫韓長林,韓老兩,他要找他的弟弟。 他弟弟叫啥名兒? 他弟弟叫——韓長——韓長波! 啥?韓長波? </s></s> 對,韓長波。</s>	neutral	neutral
<s> 白主任嗎?......查了?五十年代初期根本沒有檔案......哦,後來的檔案裏沒有這個人,哦......可以到派出所去查一下......對......好,好......謝謝你,白主任,再見。 查到了? 白主任說,五十年代初期沒有檔案。不對,檔案是有的,可能後來給銷毀了。後來的檔案裏沒這個人。可不是嗎,後來的檔案裏怎麼會有他呢? 他要是景陽鎮的老人,也用不着查檔案,問問老人就知道了。他叫啥名兒? 他叫韓長林,韓老兩,他要找他的弟弟。 他弟弟叫啥名兒? 他弟弟叫——韓長——韓長波! 啥?韓長波? 對,韓長波。 </s></s> 韓長波?不就是韓長脖嗎?</s>	surprise	surprise
<s> 白主任嗎?......查了?五十年代初期根本沒有檔案......哦,後來的檔案裏沒有這個人,哦......可以到派出所去查一下......對......好,好......謝謝你,白主任,再見。 查到了? 白主任說,五十年代初期沒有檔案。不對,檔案是有的,可能後來給銷毀了。後來的檔案裏沒這個人。可不是嗎,後來的檔案裏怎麼會有他呢? 他要是景陽鎮的老人,也用不着查檔案,問問老人就知道了。他叫啥名兒? 他叫韓長林,韓老兩,他要找他的弟弟。 他弟弟叫啥名兒? 他弟弟叫——韓長——韓長波! 啥?韓長波? 對,韓長波。 韓長波?不就是韓長脖嗎? </s></s> 韓長脖?哪個韓長脖?</s>	surprise	surprise
<s> 查到了? 白主任說,五十年代初期沒有檔案。不對,檔案是有的,可能後來給銷毀了。後來的檔案裏沒這個人。可不是嗎,後來的檔案裏怎麼會有他呢? 他要是景陽鎮的老人,也用不着查檔案,問問老人就知道了。他叫啥名兒? 他叫韓長林,韓老兩,他要找他的弟弟。 他弟弟叫啥名兒? 他弟弟叫——韓長——韓長波! 啥?韓長波? 對,韓長波。 韓長波?不就是韓長脖嗎? 韓長脖?哪個韓長脖? </s></s> 就是那個遊手好閒的韓長脖嘛。全景陽鎮誰不知道?</s>	neutral	disgust
<s> 白主任說,五十年代初期沒有檔案。不對,檔案是有的,可能後來給銷毀了。後來的檔案裏沒這個人。可不是嗎,後來的檔案裏怎麼會有他呢? 他要是景陽鎮的老人,也用不着查檔案,問問老人就知道了。他叫啥名兒? 他叫韓長林,韓老兩,他要找他的弟弟。 他弟弟叫啥名兒? 他弟弟叫——韓長——韓長波! 啥?韓長波? 對,韓長波。 韓長波?不就是韓長脖嗎? 韓長脖?哪個韓長脖? 就是那個遊手好閒的韓長脖嘛。全景陽鎮誰不知道? </s></s> 噢,對,韓長脖!有個韓長脖,我好像也聽到過。他在哪兒呢?</s>	surprise	surprise
<s> 他要是景陽鎮的老人,也用不着查檔案,問問老人就知道了。他叫啥名兒? 他叫韓長林,韓老兩,他要找他的弟弟。 他弟弟叫啥名兒? 他弟弟叫——韓長——韓長波! 啥?韓長波? 對,韓長波。 韓長波?不就是韓長脖嗎? 韓長脖?哪個韓長脖? 就是那個遊手好閒的韓長脖嘛。全景陽鎮誰不知道? 噢,對,韓長脖!有個韓長脖,我好像也聽到過。他在哪兒呢? </s></s> 前幾年老在街上轉悠,這幾年不見了。</s>	neutral	neutral
<s> 他叫韓長林,韓老兩,他要找他的弟弟。 他弟弟叫啥名兒? 他弟弟叫——韓長——韓長波! 啥?韓長波? 對,韓長波。 韓長波?不就是韓長脖嗎? 韓長脖?哪個韓長脖? 就是那個遊手好閒的韓長脖嘛。全景陽鎮誰不知道? 噢,對,韓長脖!有個韓長脖,我好像也聽到過。他在哪兒呢? 前幾年老在街上轉悠,這幾年不見了。 </s></s> 你說能是他嗎?</s>	surprise	surprise
<s> 他弟弟叫啥名兒? 他弟弟叫——韓長——韓長波! 啥?韓長波? 對,韓長波。 韓長波?不就是韓長脖嗎? 韓長脖?哪個韓長脖? 就是那個遊手好閒的韓長脖嘛。全景陽鎮誰不知道? 噢,對,韓長脖!有個韓長脖,我好像也聽到過。他在哪兒呢? 前幾年老在街上轉悠,這幾年不見了。 你說能是他嗎? </s></s> 那也背不住。以前我聽說他是鮮族人,住在高麗壩,當時也沒注意,沒多問,後來鮮族人都搬到高麗屯去了。如果他是鮮族人,可能就是他。</s>	neutral	neutral
<s> 他弟弟叫——韓長——韓長波! 啥?韓長波? 對,韓長波。 韓長波?不就是韓長脖嗎? 韓長脖?哪個韓長脖? 就是那個遊手好閒的韓長脖嘛。全景陽鎮誰不知道? 噢,對,韓長脖!有個韓長脖,我好像也聽到過。他在哪兒呢? 前幾年老在街上轉悠,這幾年不見了。 你說能是他嗎? 那也背不住。以前我聽說他是鮮族人,住在高麗壩,當時也沒注意,沒多問,後來鮮族人都搬到高麗屯去了。如果他是鮮族人,可能就是他。 </s></s> 對,如果他是鮮族人,很可能就是他。到派出所去查一查,再上高麗屯去打聽打聽就知道了。</s>	neutral	neutral
<s> 啥?韓長波? 對,韓長波。 韓長波?不就是韓長脖嗎? 韓長脖?哪個韓長脖? 就是那個遊手好閒的韓長脖嘛。全景陽鎮誰不知道? 噢,對,韓長脖!有個韓長脖,我好像也聽到過。他在哪兒呢? 前幾年老在街上轉悠,這幾年不見了。 你說能是他嗎? 那也背不住。以前我聽說他是鮮族人,住在高麗壩,當時也沒注意,沒多問,後來鮮族人都搬到高麗屯去了。如果他是鮮族人,可能就是他。 對,如果他是鮮族人,很可能就是他。到派出所去查一查,再上高麗屯去打聽打聽就知道了。 </s></s> 這事兒讓寶林跟小軍他們去就行了,用不着你去。</s>	neutral	neutral
<s> 對,韓長波。 韓長波?不就是韓長脖嗎? 韓長脖?哪個韓長脖? 就是那個遊手好閒的韓長脖嘛。全景陽鎮誰不知道? 噢,對,韓長脖!有個韓長脖,我好像也聽到過。他在哪兒呢? 前幾年老在街上轉悠,這幾年不見了。 你說能是他嗎? 那也背不住。以前我聽說他是鮮族人,住在高麗壩,當時也沒注意,沒多問,後來鮮族人都搬到高麗屯去了。如果他是鮮族人,可能就是他。 對,如果他是鮮族人,很可能就是他。到派出所去查一查,再上高麗屯去打聽打聽就知道了。 這事兒讓寶林跟小軍他們去就行了,用不着你去。 </s></s> 也行。</s>	neutral	neutral
<s></s></s> 小朋友,你們知道順子家在哪兒嗎?</s>	neutral	surprise
<s> 小朋友,你們知道順子家在哪兒嗎? </s></s> 順子?</s>	surprise	surprise
<s> 小朋友,你們知道順子家在哪兒嗎? 順子? </s></s> 對,順子,崔順子。</s>	neutral	neutral
<s> 小朋友,你們知道順子家在哪兒嗎? 順子? 對,順子,崔順子。 </s></s> 崔順子是誰?</s>	surprise	surprise
<s></s></s> 崔順子是老奶奶,她家男人姓韓。</s>	neutral	neutral
<s> 崔順子是老奶奶,她家男人姓韓。 </s></s> 姓韓?</s>	surprise	surprise
<s> 崔順子是老奶奶,她家男人姓韓。 姓韓? </s></s> 對,姓韓,叫韓長波。</s>	joy	neutral
<s> 崔順子是老奶奶,她家男人姓韓。 姓韓? 對,姓韓,叫韓長波。 </s></s> 韓長脖?</s>	surprise	surprise
<s> 崔順子是老奶奶,她家男人姓韓。 姓韓? 對,姓韓,叫韓長波。 韓長脖? </s></s> 韓長脖?</s>	surprise	surprise
<s> 崔順子是老奶奶,她家男人姓韓。 姓韓? 對,姓韓,叫韓長波。 韓長脖? 韓長脖? </s></s> 啊!韓長脖!知道,他們家就在那邊,往前走不遠,就在道邊,草房,小院子。</s>	joy	surprise
<s> 崔順子是老奶奶,她家男人姓韓。 姓韓? 對,姓韓,叫韓長波。 韓長脖? 韓長脖? 啊!韓長脖!知道,他們家就在那邊,往前走不遠,就在道邊,草房,小院子。 </s></s> 謝謝小朋友。</s>	joy	joy
<s></s></s> 順子!</s>	surprise	surprise
<s> 順子! </s></s> 順子,你好嗎?</s>	joy	joy
<s> 順子! 順子,你好嗎? </s></s> 活着就是好吧。</s>	neutral	neutral
<s></s></s> 你要多加保重!</s>	surprise	joy
<s> 你要多加保重! </s></s> 我知道。你也要多保重。長波,要聽你嫂子的話!</s>	joy	joy
<s></s></s> 現在的苞米棒子能煮着吃了嗎?</s>	surprise	joy
<s> 現在的苞米棒子能煮着吃了嗎? </s></s> 現在還不行,還不太熟,再有十來天就行了。</s>	neutral	joy
<s></s></s> 唉!都是我害了你們。好在那個時代過去了,都過去了,不會再回來了。現在日子好過了,很多人都出國旅遊,探親。你們不想出去看看嗎?</s>	sadness	sadness
<s> 唉!都是我害了你們。好在那個時代過去了,都過去了,不會再回來了。現在日子好過了,很多人都出國旅遊,探親。你們不想出去看看嗎? </s></s> 連你我都不想看,還去看誰?</s>	angry	disgust
<s></s></s> 吃飯的時間到了,你在這吃飯吧。長波怎麼沒來?去把他接來吧。</s>	neutral	surprise
<s> 吃飯的時間到了,你在這吃飯吧。長波怎麼沒來?去把他接來吧。 </s></s> 不用了。我們都不習慣在外邊吃飯,家裏還有豬狗雞,沒人照看不行。</s>	neutral	neutral
<s></s></s> 不行,今天來不及,沒跟飯店聯繫,我這裏還有事兒。</s>	fear	fear
<s> 不行,今天來不及,沒跟飯店聯繫,我這裏還有事兒。 </s></s> 明天也行。你妹妹叫啥名兒?</s>	surprise	surprise
<s></s></s> 東哥!你來得正好。</s>	joy	joy
<s> 東哥!你來得正好。 </s></s> 美玉!你等半天了嗎?</s>	joy	surprise
<s> 東哥!你來得正好。 美玉!你等半天了嗎? </s></s> 沒有,我剛出來。</s>	neutral	joy
<s> 東哥!你來得正好。 美玉!你等半天了嗎? 沒有,我剛出來。 </s></s> 大爺呢?</s>	surprise	surprise
<s> 東哥!你來得正好。 美玉!你等半天了嗎? 沒有,我剛出來。 大爺呢? </s></s> 他在屋裏休息。咱們走吧?</s>	joy	joy
<s> 東哥!你來得正好。 美玉!你等半天了嗎? 沒有,我剛出來。 大爺呢? 他在屋裏休息。咱們走吧? </s></s> 走吧。</s>	neutral	joy
<s></s></s> 對,一樣,就是小。</s>	neutral	neutral
<s> 對,一樣,就是小。 </s></s> 跟大火車跑得一樣快嗎?</s>	surprise	surprise
<s> 對,一樣,就是小。 跟大火車跑得一樣快嗎? </s></s> 沒有大火車快。</s>	neutral	joy
<s> 對,一樣,就是小。 跟大火車跑得一樣快嗎? 沒有大火車快。 </s></s> 你坐過嗎?</s>	surprise	surprise
<s> 對,一樣,就是小。 跟大火車跑得一樣快嗎? 沒有大火車快。 你坐過嗎? </s></s> 坐過。</s>	joy	joy
<s> 對,一樣,就是小。 跟大火車跑得一樣快嗎? 沒有大火車快。 你坐過嗎? 坐過。 </s></s> 舒服嗎?</s>	joy	surprise
<s> 對,一樣,就是小。 跟大火車跑得一樣快嗎? 沒有大火車快。 你坐過嗎? 坐過。 舒服嗎? </s></s> 不舒服,又顛又晃,還響。</s>	neutral	disgust
<s> 對,一樣,就是小。 跟大火車跑得一樣快嗎? 沒有大火車快。 你坐過嗎? 坐過。 舒服嗎? 不舒服,又顛又晃,還響。 </s></s> 那可能挺有意思吧?</s>	joy	joy
<s> 對,一樣,就是小。 跟大火車跑得一樣快嗎? 沒有大火車快。 你坐過嗎? 坐過。 舒服嗎? 不舒服,又顛又晃,還響。 那可能挺有意思吧? </s></s> 是,跟玩具一樣。</s>	joy	joy
<s> 對,一樣,就是小。 跟大火車跑得一樣快嗎? 沒有大火車快。 你坐過嗎? 坐過。 舒服嗎? 不舒服,又顛又晃,還響。 那可能挺有意思吧? 是,跟玩具一樣。 </s></s> 咱們回去就坐一坐吧?</s>	joy	joy
<s> 對,一樣,就是小。 跟大火車跑得一樣快嗎? 沒有大火車快。 你坐過嗎? 坐過。 舒服嗎? 不舒服,又顛又晃,還響。 那可能挺有意思吧? 是,跟玩具一樣。 咱們回去就坐一坐吧? </s></s> 不用,咱們有車。</s>	joy	neutral
<s></s></s> 馬軍,你去結帳吧,我回宿捨去一下。</s>	neutral	neutral
<s> 馬軍,你去結帳吧,我回宿捨去一下。 </s></s> 好吧,你快一點。</s>	neutral	neutral
<s></s></s> 現在能抽菸了嗎?</s>	surprise	surprise
<s> 現在能抽菸了嗎? </s></s> 可以了。</s>	joy	joy
<s></s></s> 這個公司就你們兩個人嗎?</s>	surprise	surprise
<s> 這個公司就你們兩個人嗎? </s></s> 三個人。</s>	neutral	neutral
<s> 這個公司就你們兩個人嗎? 三個人。 </s></s> 這木頭到了景陽鎮火車站能馬上走嗎?</s>	surprise	surprise
<s> 這個公司就你們兩個人嗎? 三個人。 這木頭到了景陽鎮火車站能馬上走嗎? </s></s> 不一定,現在車皮很緊張。我們已經有人在那邊聯繫了,儘量爭取早點要到車皮,快一點發出去。</s>	neutral	fear
<s> 這個公司就你們兩個人嗎? 三個人。 這木頭到了景陽鎮火車站能馬上走嗎? 不一定,現在車皮很緊張。我們已經有人在那邊聯繫了,儘量爭取早點要到車皮,快一點發出去。 </s></s> 那邊的運費在哪兒付?</s>	surprise	surprise
<s> 這個公司就你們兩個人嗎? 三個人。 這木頭到了景陽鎮火車站能馬上走嗎? 不一定,現在車皮很緊張。我們已經有人在那邊聯繫了,儘量爭取早點要到車皮,快一點發出去。 那邊的運費在哪兒付? </s></s> 當然在那邊付,咱們這裏也不知道運費是多少錢。</s>	neutral	neutral
<s></s></s> 我們這裏咋樣,好嗎?</s>	fear	surprise
<s> 我們這裏咋樣,好嗎? </s></s> 好呀,太好了!我沒想到會這麼好。</s>	joy	joy
<s></s></s> 是嗎?</s>	surprise	surprise
<s> 是嗎? </s></s> 我爸總說他的老家是農村,都是農民,很窮,很苦。可是我來了也沒看見農民呀。</s>	sadness	joy
<s></s></s> 農民還是有的,但工人越來越多了,年輕人都不願意種地。現在的農民也不苦了。你爸說的那是以前。你爸來過景陽鎮嗎?</s>	neutral	neutral
<s> 農民還是有的,但工人越來越多了,年輕人都不願意種地。現在的農民也不苦了。你爸說的那是以前。你爸來過景陽鎮嗎? </s></s> 他就是景陽鎮的人,是從景陽鎮出去的。</s>	neutral	neutral
<s></s></s> 是嗎?那咱們還應該是老鄉嘛!</s>	joy	joy
<s> 是嗎?那咱們還應該是老鄉嘛! </s></s> 對呀,咱們是老鄉。</s>	joy	joy
<s></s></s> 辦完了嗎?</s>	surprise	surprise
<s> 辦完了嗎? </s></s> 完了。</s>	joy	neutral
<s> 辦完了嗎? 完了。 </s></s> 打電話問問曉華姐,車皮聯繫好了沒有。</s>	neutral	joy
<s> 辦完了嗎? 完了。 打電話問問曉華姐,車皮聯繫好了沒有。 </s></s> 過去了再問吧。</s>	neutral	neutral
<s></s></s> 這邊小火車大概也得一兩天才能發車,那邊有了車皮,過去就能裝大火車。你放心吧,不會有啥問題,到時候我們會通知你。你也可以到車站調度室去問。</s>	neutral	joy
<s> 這邊小火車大概也得一兩天才能發車,那邊有了車皮,過去就能裝大火車。你放心吧,不會有啥問題,到時候我們會通知你。你也可以到車站調度室去問。 </s></s> 好吧,謝謝你。</s>	joy	joy
<s> 這邊小火車大概也得一兩天才能發車,那邊有了車皮,過去就能裝大火車。你放心吧,不會有啥問題,到時候我們會通知你。你也可以到車站調度室去問。 好吧,謝謝你。 </s></s> 不客氣。</s>	joy	joy
<s> 這邊小火車大概也得一兩天才能發車,那邊有了車皮,過去就能裝大火車。你放心吧,不會有啥問題,到時候我們會通知你。你也可以到車站調度室去問。 好吧,謝謝你。 不客氣。 </s></s> 咱們走吧,曉華姐該等急了。</s>	joy	fear
<s></s></s> 曉華姐這兩天有點累了,我替她爲遠方來的客人敬一杯,乾杯!</s>	joy	joy
<s> 曉華姐這兩天有點累了,我替她爲遠方來的客人敬一杯,乾杯! </s></s> 謝謝。</s>	neutral	joy
<s> 曉華姐這兩天有點累了,我替她爲遠方來的客人敬一杯,乾杯! 謝謝。 </s></s> 別光喝酒了,大家吃菜!</s>	joy	joy
<s></s></s> “美玉小姐不遠千里而來,給我們景陽鎮增光不少。我向你表示歡迎,向你和韓東表示祝賀。</s>	joy	joy
<s> “美玉小姐不遠千里而來,給我們景陽鎮增光不少。我向你表示歡迎,向你和韓東表示祝賀。 </s></s> 來,韓東,我祝賀你,咱倆先乾一杯!</s>	joy	joy
<s> “美玉小姐不遠千里而來,給我們景陽鎮增光不少。我向你表示歡迎,向你和韓東表示祝賀。 來,韓東,我祝賀你,咱倆先乾一杯! </s></s> 不行,不能喝,我還要開車。</s>	neutral	fear
<s> “美玉小姐不遠千里而來,給我們景陽鎮增光不少。我向你表示歡迎,向你和韓東表示祝賀。 來,韓東,我祝賀你,咱倆先乾一杯! 不行,不能喝,我還要開車。 </s></s> 我們倆今天不回青河了,你也不用開車了,喝一點沒關係。</s>	joy	joy
<s> “美玉小姐不遠千里而來,給我們景陽鎮增光不少。我向你表示歡迎,向你和韓東表示祝賀。 來,韓東,我祝賀你,咱倆先乾一杯! 不行,不能喝,我還要開車。 我們倆今天不回青河了,你也不用開車了,喝一點沒關係。 </s></s> 好吧,少喝一點。</s>	joy	joy
<s></s></s> 來,咱們大家一起再乾一杯,熱烈歡迎美玉小姐到中國來,到景陽鎮來,爲咱們的友誼乾杯!</s>	joy	joy
<s> 來,咱們大家一起再乾一杯,熱烈歡迎美玉小姐到中國來,到景陽鎮來,爲咱們的友誼乾杯! </s></s> “我真的不會唱歌,中國話也說得不好。但這並不妨礙表達我的感情。在我們那裏有個習慣,如果家裏有客人來,特別是遠方的客人來,客人會把他的祝願留下來。主人也會認爲客人的祝願,特別是遠方客人的祝願最寶貴,最美好。今天,作爲遠方的客人,我把我的祝願留給你們,我的好朋友。</s>	joy	joy
<s></s></s> “嗯,幾句話都差不多。</s>	neutral	neutral
<s> “嗯,幾句話都差不多。 </s></s> 誰先說?</s>	surprise	surprise
<s></s></s> “那是什麼?比翼雙飛......喝喜酒......還臨時請來外國客人......又門庭若市......知道了!雙--喜--臨--門,對不對?</s>	surprise	joy
<s> “那是什麼?比翼雙飛......喝喜酒......還臨時請來外國客人......又門庭若市......知道了!雙--喜--臨--門,對不對? </s></s> 好啊!大家都得了滿分。來吧,祝賀大家取得好成績,一起幹杯!</s>	joy	joy
<s></s></s> 酒喝得差不多了,咱們去唱歌吧!曉華姐,在歌廳定座了嗎?</s>	joy	joy
<s> 酒喝得差不多了,咱們去唱歌吧!曉華姐,在歌廳定座了嗎? </s></s> 定了,現在可以去了。</s>	joy	joy
<s> 酒喝得差不多了,咱們去唱歌吧!曉華姐,在歌廳定座了嗎? 定了,現在可以去了。 </s></s> 好,咱們走吧。美玉小姐,咱們去唱歌吧!</s>	joy	joy
<s> 酒喝得差不多了,咱們去唱歌吧!曉華姐,在歌廳定座了嗎? 定了,現在可以去了。 好,咱們走吧。美玉小姐,咱們去唱歌吧! </s></s> 好吧。</s>	joy	joy
<s></s></s> 曉華姐,你見韓東他大爺了嗎?</s>	neutral	surprise
<s> 曉華姐,你見韓東他大爺了嗎? </s></s> 沒有。美玉我也是第一次見。</s>	neutral	neutral
<s></s></s> 那這幾天你倆沒在一起嗎?</s>	surprise	surprise
<s> 那這幾天你倆沒在一起嗎? </s></s> 誰倆?</s>	surprise	surprise
<s></s></s> 韓東你倆唄!</s>	joy	surprise
<s> 韓東你倆唄! </s></s> 我說韓東,咱們不是說好了嗎,叫你去找曉華,你咋不去呢?</s>	surprise	angry
<s> 韓東你倆唄! 我說韓東,咱們不是說好了嗎,叫你去找曉華,你咋不去呢? </s></s> 我去了,她不在家。</s>	neutral	sadness
<s></s></s> 噢,我想起來了,韓東跟我說過,他去找過你,你沒在。我還沒跟你們說呢,我把那個小丫頭片子收拾了一頓,這回看她還敢不敢胡說八道!</s>	surprise	angry
<s> 噢,我想起來了,韓東跟我說過,他去找過你,你沒在。我還沒跟你們說呢,我把那個小丫頭片子收拾了一頓,這回看她還敢不敢胡說八道! </s></s> 你怎麼收拾她了?</s>	surprise	surprise
<s></s></s> 我上她們車間了,當着她們工人的面兒把她臭罵了一頓,把她的工具箱給她掀了。</s>	angry	joy
<s> 我上她們車間了,當着她們工人的面兒把她臭罵了一頓,把她的工具箱給她掀了。 </s></s> 你自個兒?</s>	surprise	surprise
<s></s></s> 我還帶了兩個姑娘。</s>	neutral	joy
<s> 我還帶了兩個姑娘。 </s></s> 她說什麼了?</s>	surprise	surprise
<s> 我還帶了兩個姑娘。 她說什麼了? </s></s> 她能說什麼?</s>	surprise	disgust
<s> 我還帶了兩個姑娘。 她說什麼了? 她能說什麼? </s></s> 你太過分了吧?</s>	angry	angry
<s> 我還帶了兩個姑娘。 她說什麼了? 她能說什麼? 你太過分了吧? </s></s> 要說我過分了,那就是你也過分了,就爲了她那麼一句話,你還就當真了?我看她說的就是氣話,故意傷你,氣你。你要真生氣了,那就上她的當了。</s>	angry	angry
<s></s></s> 主要怪我,那天我不夠冷靜,說的話也不合適。</s>	sadness	sadness
<s> 主要怪我,那天我不夠冷靜,說的話也不合適。 </s></s> 好了好了,這件事就算過去了。你倆抽空好好談談。韓東也不在那上班了,她也沒理由再去找韓東了。</s>	joy	neutral
<s></s></s> 好吧,我去點一個。</s>	neutral	neutral
<s> 好吧,我去點一個。 </s></s> 還是你去跳吧,你跳得真好。</s>	joy	joy
<s> 好吧,我去點一個。 還是你去跳吧,你跳得真好。 </s></s> 這是一個慢四的曲子,咱倆再跳一個吧。</s>	joy	joy
<s></s></s> 美玉,你回去吧,我們走了。</s>	joy	joy
<s> 美玉,你回去吧,我們走了。 </s></s> 美玉再見!給你爸爸問好。</s>	joy	joy
<s> 美玉,你回去吧,我們走了。 美玉再見!給你爸爸問好。 </s></s> 謝謝,再見!</s>	joy	joy
<s></s></s> 咱們從山上下來還是第一次見面吧?</s>	joy	surprise
<s> 咱們從山上下來還是第一次見面吧? </s></s> 見過面,但沒在一塊吃過飯,沒嘮過。</s>	neutral	neutral
<s></s></s> 你們混得不錯吧?</s>	joy	joy
<s> 你們混得不錯吧? </s></s> 啥不錯呀,連個正經工作都沒有。</s>	sadness	disgust
<s> 你們混得不錯吧? 啥不錯呀,連個正經工作都沒有。 </s></s> 當臨時工,哪像你呀?</s>	surprise	sadness
<s></s></s> 我這也不是正式工,大集體。</s>	neutral	sadness
<s> 我這也不是正式工,大集體。 </s></s> 管大集體小集體,有個固定地方也行呀,不像我們,幹一天算一天,今天幹了還不知道明天幹啥呢。</s>	joy	disgust
<s> 我這也不是正式工,大集體。 管大集體小集體,有個固定地方也行呀,不像我們,幹一天算一天,今天幹了還不知道明天幹啥呢。 </s></s> 單位還給你個宿舍,有地方住。我們還得天天回家睡覺。</s>	joy	disgust
<s></s></s> 這倒是,老在家睡就是彆扭,又遠,地方又小。</s>	sadness	sadness
<s> 這倒是,老在家睡就是彆扭,又遠,地方又小。 </s></s> 就衝這點,我都想上林場去幹。林場不管咋的吃住是不成問題的,掙的還能多點兒。</s>	joy	sadness
<s> 這倒是,老在家睡就是彆扭,又遠,地方又小。 就衝這點,我都想上林場去幹。林場不管咋的吃住是不成問題的,掙的還能多點兒。 </s></s> 對,就像馬軍他們那樣。</s>	joy	neutral
<s> 這倒是,老在家睡就是彆扭,又遠,地方又小。 就衝這點,我都想上林場去幹。林場不管咋的吃住是不成問題的,掙的還能多點兒。 對,就像馬軍他們那樣。 </s></s> 跟他們不一樣。他們是作生意,我是去給單位幹,打工。</s>	joy	disgust
<s> 這倒是,老在家睡就是彆扭,又遠,地方又小。 就衝這點,我都想上林場去幹。林場不管咋的吃住是不成問題的,掙的還能多點兒。 對,就像馬軍他們那樣。 跟他們不一樣。他們是作生意,我是去給單位幹,打工。 </s></s> 咱們不能作生意?</s>	surprise	surprise
<s> 這倒是,老在家睡就是彆扭,又遠,地方又小。 就衝這點,我都想上林場去幹。林場不管咋的吃住是不成問題的,掙的還能多點兒。 對,就像馬軍他們那樣。 跟他們不一樣。他們是作生意,我是去給單位幹,打工。 咱們不能作生意? </s></s> 生意可不是誰都能作的,那得有關係。</s>	neutral	sadness
<s></s></s> 還是在鎮上幹吧,不行幹個體也行。我都想幹個體。</s>	joy	neutral
<s> 還是在鎮上幹吧,不行幹個體也行。我都想幹個體。 </s></s> 你想幹啥?我們也跟你幹吧?</s>	surprise	surprise
<s> 還是在鎮上幹吧,不行幹個體也行。我都想幹個體。 你想幹啥?我們也跟你幹吧? </s></s> 對,咱們一塊幹!</s>	joy	joy
<s></s></s> 我想開飯店,可是本錢不夠。</s>	sadness	sadness
<s> 我想開飯店,可是本錢不夠。 </s></s> 開飯店要啥本錢?</s>	surprise	surprise
<s></s></s> 咋不要本錢?租房子,顧大師傅,手裏還得有現錢採購。</s>	surprise	surprise
<s> 咋不要本錢?租房子,顧大師傅,手裏還得有現錢採購。 </s></s> 不着急,咱們先這樣幹着,攢錢,等錢攢夠了再開。</s>	joy	joy
<s></s></s> 徐麗!你怎麼來了?</s>	surprise	surprise
<s> 徐麗!你怎麼來了? </s></s> 你們幹啥呢?吃飯呢!</s>	surprise	joy
<s></s></s> 來,一塊吃點吧。</s>	joy	joy
<s> 來,一塊吃點吧。 </s></s> 好啊!</s>	joy	joy
<s></s></s> 你來晚了,罰一杯!</s>	angry	joy
<s> 你來晚了,罰一杯! </s></s> 好,東哥你陪我喝!</s>	joy	joy
<s></s></s> 麗麗,你幹啥活呢?</s>	surprise	surprise
<s> 麗麗,你幹啥活呢? </s></s> 我在勞服呢。</s>	neutral	neutral
<s> 麗麗,你幹啥活呢? 我在勞服呢。 </s></s> 勞服?啥是勞服?</s>	surprise	surprise
<s></s></s> 勞動服務公司。</s>	neutral	neutral
<s> 勞動服務公司。 </s></s> 噢,勞動服務公司,大集體,在那幹啥?</s>	surprise	surprise
<s></s></s> 工人唄,工人還能幹啥?</s>	surprise	sadness
<s> 工人唄,工人還能幹啥? </s></s> 我是說,你們那勞服是幹啥的?服務行業嗎?</s>	surprise	surprise
<s></s></s> 不是,是金屬加工,做鋼絲的,她們那挺好。</s>	joy	joy
<s> 不是,是金屬加工,做鋼絲的,她們那挺好。 </s></s> 有啥好的?到現在還沒開工呢。我都不想在那幹了。</s>	disgust	disgust
<s></s></s> 開工是早晚的事,那是個正經行業。</s>	joy	joy
<s> 開工是早晚的事,那是個正經行業。 </s></s> 是嗎?謝謝東哥,陪我喝一個!</s>	joy	joy
<s></s></s> 我不行了,你跟他們喝吧。</s>	fear	fear
<s> 我不行了,你跟他們喝吧。 </s></s> 他是不行了,來,我們陪你喝!</s>	fear	joy
<s></s></s> 你們怎麼想起來一塊喝酒了?</s>	surprise	surprise
<s> 你們怎麼想起來一塊喝酒了? </s></s> 是他叫我們來的,說要跟我們商量事兒。</s>	joy	joy
<s></s></s> 商量啥事兒?</s>	surprise	surprise
<s> 商量啥事兒? </s></s> 商量開飯店的事兒。</s>	joy	joy
<s></s></s> 開飯店?東哥,你想開飯店?我咋沒聽你說呢?</s>	surprise	surprise
<s> 開飯店?東哥,你想開飯店?我咋沒聽你說呢? </s></s> 我也就是隨便那麼一說。</s>	neutral	neutral
<s></s></s> 這個主意不錯嘛!開吧,帶我一個,我也來!</s>	joy	joy
<s> 這個主意不錯嘛!開吧,帶我一個,我也來! </s></s> 他說現在本錢不夠,等攢夠了本錢再說。</s>	neutral	neutral
<s></s></s> 行,到時候我一定來!</s>	joy	joy
<s> 行,到時候我一定來! </s></s> 東哥!你咋的了?酒還沒喝完呢。</s>	surprise	surprise
<s> 行,到時候我一定來! 東哥!你咋的了?酒還沒喝完呢。 </s></s> 他不咋能喝酒,已經醉了,咱們也撤吧。</s>	neutral	neutral
<s> 行,到時候我一定來! 東哥!你咋的了?酒還沒喝完呢。 他不咋能喝酒,已經醉了,咱們也撤吧。 </s></s> 撤吧。麗麗,你喝夠了嗎?</s>	angry	joy
<s></s></s> 啥夠不夠的,撤了吧。你們先走,我幫他收拾收拾。</s>	neutral	neutral
<s> 啥夠不夠的,撤了吧。你們先走,我幫他收拾收拾。 </s></s> 那就辛苦你了,我們走吧。</s>	joy	joy
<s></s></s> 你們還想唱一會兒嗎?</s>	joy	surprise
<s> 你們還想唱一會兒嗎? </s></s> 不唱了,走吧。</s>	neutral	joy
<s> 你們還想唱一會兒嗎? 不唱了,走吧。 </s></s> 走吧。曉華姐你怎麼又回來了?</s>	surprise	surprise
<s> 你們還想唱一會兒嗎? 不唱了,走吧。 走吧。曉華姐你怎麼又回來了? </s></s> 我也回青河。</s>	joy	neutral
<s> 你們還想唱一會兒嗎? 不唱了,走吧。 走吧。曉華姐你怎麼又回來了? 我也回青河。 </s></s> 那咱們一塊走吧。</s>	joy	joy
<s></s></s> 我回去了。</s>	neutral	neutral
<s> 我回去了。 </s></s> 韓東,慢點。</s>	neutral	neutral
<s> 我回去了。 韓東,慢點。 </s></s> 知道。你們進去吧。</s>	neutral	joy
<s></s></s> 叫袁德富過來一下!</s>	joy	neutral
<s> 叫袁德富過來一下! </s></s> 科長叫我?</s>	surprise	fear
<s> 叫袁德富過來一下! 科長叫我? </s></s> 咱們印刷廠在節前買了兩臺印刷機,花了八十六萬元。有人反映說機器是二手貨,機器來了印不了報,國慶專刊還是在哈爾濱人家的廠裏印的。唐局長叫咱們去調查一下。這個週末你回家的時候到哈爾濱去一下,找到賣機器那個單位問一問是怎麼回事?究竟是不是二手貨?價錢對不對?價錢不對該不該給咱們退錢?</s>	surprise	angry
<s> 叫袁德富過來一下! 科長叫我? 咱們印刷廠在節前買了兩臺印刷機,花了八十六萬元。有人反映說機器是二手貨,機器來了印不了報,國慶專刊還是在哈爾濱人家的廠裏印的。唐局長叫咱們去調查一下。這個週末你回家的時候到哈爾濱去一下,找到賣機器那個單位問一問是怎麼回事?究竟是不是二手貨?價錢對不對?價錢不對該不該給咱們退錢? </s></s> 行。那我禮拜一晚回來一天?</s>	joy	fear
<s> 叫袁德富過來一下! 科長叫我? 咱們印刷廠在節前買了兩臺印刷機,花了八十六萬元。有人反映說機器是二手貨,機器來了印不了報,國慶專刊還是在哈爾濱人家的廠裏印的。唐局長叫咱們去調查一下。這個週末你回家的時候到哈爾濱去一下,找到賣機器那個單位問一問是怎麼回事?究竟是不是二手貨?價錢對不對?價錢不對該不該給咱們退錢? 行。那我禮拜一晚回來一天? </s></s> 晚回來一天兩天都行。你把他們的發票找出來帶上。</s>	neutral	neutral
<s></s></s> 我給你開了個條兒,你帶上,省得人家不給你查。</s>	neutral	neutral
<s> 我給你開了個條兒,你帶上,省得人家不給你查。 </s></s> 介紹信應該蓋行政公章,財務專用章哪行?</s>	surprise	surprise
<s> 我給你開了個條兒,你帶上,省得人家不給你查。 介紹信應該蓋行政公章,財務專用章哪行? </s></s> 沒關係,跟財務部門打交道,證明你是咱們單位的會計人員就行,就是查一筆帳,咱們又不是外調,不是還有發票嗎?他們不要,你也不用拿出來。他們一定要看,你再給他。</s>	neutral	joy
<s> 我給你開了個條兒,你帶上,省得人家不給你查。 介紹信應該蓋行政公章,財務專用章哪行? 沒關係,跟財務部門打交道,證明你是咱們單位的會計人員就行,就是查一筆帳,咱們又不是外調,不是還有發票嗎?他們不要,你也不用拿出來。他們一定要看,你再給他。 </s></s> 好的。</s>	neutral	neutral
<s> 我給你開了個條兒,你帶上,省得人家不給你查。 介紹信應該蓋行政公章,財務專用章哪行? 沒關係,跟財務部門打交道,證明你是咱們單位的會計人員就行,就是查一筆帳,咱們又不是外調,不是還有發票嗎?他們不要,你也不用拿出來。他們一定要看,你再給他。 好的。 </s></s> 火車票留着回來報銷。</s>	neutral	neutral
<s> 我給你開了個條兒,你帶上,省得人家不給你查。 介紹信應該蓋行政公章,財務專用章哪行? 沒關係,跟財務部門打交道,證明你是咱們單位的會計人員就行,就是查一筆帳,咱們又不是外調,不是還有發票嗎?他們不要,你也不用拿出來。他們一定要看,你再給他。 好的。 火車票留着回來報銷。 </s></s> 沒事兒!</s>	disgust	joy
<s></s></s> 科長,你找我?</s>	surprise	surprise
<s> 科長,你找我? </s></s> 小馬!你過來了?</s>	surprise	surprise
<s></s></s> 你幹得怎麼樣?</s>	angry	surprise
<s> 你幹得怎麼樣? </s></s> 湊合事兒唄。</s>	joy	neutral
<s> 你幹得怎麼樣? 湊合事兒唄。 </s></s> 還挺忙活,找都不好找。</s>	sadness	neutral
<s></s></s> 大山裏,肯定沒有在鎮上方便。</s>	neutral	neutral
<s> 大山裏,肯定沒有在鎮上方便。 </s></s> 你坐下。有件事問問你,你買印刷機的事辦完了沒有?</s>	surprise	angry
<s></s></s> 機器是在哪兒買的?</s>	surprise	angry
<s> 機器是在哪兒買的? </s></s> 哈爾濱什麼地方?什麼單位?</s>	surprise	angry
<s> 機器是在哪兒買的? 哈爾濱什麼地方?什麼單位? </s></s> 花了多少錢?</s>	surprise	angry
<s> 機器是在哪兒買的? 哈爾濱什麼地方?什麼單位? 花了多少錢? </s></s> 機器都安裝好了嗎?</s>	surprise	angry
<s> 機器是在哪兒買的? 哈爾濱什麼地方?什麼單位? 花了多少錢? 機器都安裝好了嗎? </s></s> 安裝好了。</s>	neutral	neutral
<s> 機器是在哪兒買的? 哈爾濱什麼地方?什麼單位? 花了多少錢? 機器都安裝好了嗎? 安裝好了。 </s></s> 我聽到反映,說你那兩臺機器不是從哈爾濱印刷器材公司買的?</s>	surprise	angry
<s></s></s> 東哥!你來啦?</s>	surprise	joy
<s> 東哥!你來啦? </s></s> 東哥,好看嗎?</s>	joy	joy
<s> 東哥!你來啦? 東哥,好看嗎? </s></s> 好看,太漂亮了!我都認不出來了,以爲又來了兩個朝鮮客人呢!</s>	joy	joy
<s></s></s> 是嗎?好久沒穿這件衣服,有點不習慣了。</s>	surprise	joy
<s> 是嗎?好久沒穿這件衣服,有點不習慣了。 </s></s> 還是咱們的民族服裝好看。</s>	joy	joy
<s></s></s> 二哥!</s>	surprise	joy
<s> 二哥! </s></s> 這就是你們的家?</s>	surprise	surprise
<s> 二哥! 這就是你們的家? </s></s> 是呀,怎麼樣?</s>	joy	joy
<s> 二哥! 這就是你們的家? 是呀,怎麼樣? </s></s> “挺好,農家小院兒,</s>	joy	joy
<s></s></s> 有三十年了。</s>	neutral	sadness
<s> 有三十年了。 </s></s> 我走的時候是在高麗壩。</s>	neutral	sadness
<s></s></s> 對,高麗壩,那裏也都是朝鮮人。</s>	neutral	joy
<s> 對,高麗壩,那裏也都是朝鮮人。 </s></s> 這次回來我還到高麗壩去看了一下,全變了,找不出當年的樣子了。</s>	sadness	sadness
<s></s></s> 當年什麼樣我都不記得了。</s>	sadness	sadness
<s> 當年什麼樣我都不記得了。 </s></s> 唉!都是我不好,我當初不該走,不該離開家去當兵!</s>	sadness	sadness
<s> 當年什麼樣我都不記得了。 唉!都是我不好,我當初不該走,不該離開家去當兵! </s></s> 你當兵是響應政府號召,抗美援朝,有啥不好?</s>	neutral	disgust
<s> 當年什麼樣我都不記得了。 唉!都是我不好,我當初不該走,不該離開家去當兵! 你當兵是響應政府號召,抗美援朝,有啥不好? </s></s> 我不該再回來!</s>	angry	sadness
<s> 當年什麼樣我都不記得了。 唉!都是我不好,我當初不該走,不該離開家去當兵! 你當兵是響應政府號召,抗美援朝,有啥不好? 我不該再回來! </s></s> 這是你的家,爲啥不該回來?</s>	surprise	surprise
<s></s></s> 二哥,吃打糕!快嚐嚐,順子做的打糕多好吃。你在外邊能吃上打糕嗎?</s>	joy	joy
<s> 二哥,吃打糕!快嚐嚐,順子做的打糕多好吃。你在外邊能吃上打糕嗎? </s></s> 嗯,好吃好吃!有十幾年沒吃了,我不會做。美玉,你不是想打糕嗎?快吃吧!</s>	joy	joy
<s> 二哥,吃打糕!快嚐嚐,順子做的打糕多好吃。你在外邊能吃上打糕嗎? 嗯,好吃好吃!有十幾年沒吃了,我不會做。美玉,你不是想打糕嗎?快吃吧! </s></s> 二哥,今天高興,咱們喝點酒吧。</s>	joy	joy
<s> 二哥,吃打糕!快嚐嚐,順子做的打糕多好吃。你在外邊能吃上打糕嗎? 嗯,好吃好吃!有十幾年沒吃了,我不會做。美玉,你不是想打糕嗎?快吃吧! 二哥,今天高興,咱們喝點酒吧。 </s></s> 好,好,咱們一塊喝點酒。</s>	joy	joy
<s></s></s> 大爺,美玉,你們知道今天是什麼日子嗎?</s>	joy	joy
<s> 大爺,美玉,你們知道今天是什麼日子嗎? </s></s> 今天是什麼日子?</s>	surprise	surprise
<s> 大爺,美玉,你們知道今天是什麼日子嗎? 今天是什麼日子? </s></s> 今天是重陽節!</s>	joy	joy
<s> 大爺,美玉,你們知道今天是什麼日子嗎? 今天是什麼日子? 今天是重陽節! </s></s> 對,今天是重陽節!</s>	joy	joy
<s> 大爺,美玉,你們知道今天是什麼日子嗎? 今天是什麼日子? 今天是重陽節! 對,今天是重陽節! </s></s> 重陽節?</s>	surprise	surprise
<s> 大爺,美玉,你們知道今天是什麼日子嗎? 今天是什麼日子? 今天是重陽節! 對,今天是重陽節! 重陽節? </s></s> 對,今天是重陽節,可今天還是我媽的生日呢!</s>	joy	joy
<s> 大爺,美玉,你們知道今天是什麼日子嗎? 今天是什麼日子? 今天是重陽節! 對,今天是重陽節! 重陽節? 對,今天是重陽節,可今天還是我媽的生日呢! </s></s> 今天是媽媽的生日?</s>	surprise	surprise
<s> 大爺,美玉,你們知道今天是什麼日子嗎? 今天是什麼日子? 今天是重陽節! 對,今天是重陽節! 重陽節? 對,今天是重陽節,可今天還是我媽的生日呢! 今天是媽媽的生日? </s></s> 對呀!今天是我媽的生日!</s>	joy	joy
<s> 大爺,美玉,你們知道今天是什麼日子嗎? 今天是什麼日子? 今天是重陽節! 對,今天是重陽節! 重陽節? 對,今天是重陽節,可今天還是我媽的生日呢! 今天是媽媽的生日? 對呀!今天是我媽的生日! </s></s> “順子的生日?讓我想想,今天是十月十號</s>	surprise	surprise
<s></s></s> 十月十號?順子的生日?我怎麼不知道?</s>	surprise	surprise
<s> 十月十號?順子的生日?我怎麼不知道? </s></s> 你從來不給我媽過生日,你怎麼能知道?</s>	angry	disgust
<s> 十月十號?順子的生日?我怎麼不知道? 你從來不給我媽過生日,你怎麼能知道? </s></s> 那你怎麼知道?</s>	surprise	surprise
<s> 十月十號?順子的生日?我怎麼不知道? 你從來不給我媽過生日,你怎麼能知道? 那你怎麼知道? </s></s> 是我小的時候我媽告訴我的。</s>	neutral	joy
<s> 十月十號?順子的生日?我怎麼不知道? 你從來不給我媽過生日,你怎麼能知道? 那你怎麼知道? 是我小的時候我媽告訴我的。 </s></s> 難得孩子這麼孝順,還記得媽媽的生日。</s>	joy	joy
<s> 十月十號?順子的生日?我怎麼不知道? 你從來不給我媽過生日,你怎麼能知道? 那你怎麼知道? 是我小的時候我媽告訴我的。 難得孩子這麼孝順,還記得媽媽的生日。 </s></s> 今天正好全家團聚,就給媽媽過個生日吧!</s>	joy	joy
<s> 十月十號?順子的生日?我怎麼不知道? 你從來不給我媽過生日,你怎麼能知道? 那你怎麼知道? 是我小的時候我媽告訴我的。 難得孩子這麼孝順,還記得媽媽的生日。 今天正好全家團聚,就給媽媽過個生日吧! </s></s> 對!咱們全家祝願媽媽生日快樂!</s>	joy	joy
<s> 十月十號?順子的生日?我怎麼不知道? 你從來不給我媽過生日,你怎麼能知道? 那你怎麼知道? 是我小的時候我媽告訴我的。 難得孩子這麼孝順,還記得媽媽的生日。 今天正好全家團聚,就給媽媽過個生日吧! 對!咱們全家祝願媽媽生日快樂! </s></s> 祝媽媽身體健康!</s>	joy	joy
<s></s></s> 這麼多年了,我沒給你過生日,把日子都忘了,今天借這個機會給你過個生日,長波,咱倆一塊祝願順子生日快樂,身體健康!</s>	joy	joy
<s> 這麼多年了,我沒給你過生日,把日子都忘了,今天借這個機會給你過個生日,長波,咱倆一塊祝願順子生日快樂,身體健康! </s></s> 好!祝你生日快樂,身體健康!</s>	joy	joy
<s> 這麼多年了,我沒給你過生日,把日子都忘了,今天借這個機會給你過個生日,長波,咱倆一塊祝願順子生日快樂,身體健康! 好!祝你生日快樂,身體健康! </s></s> 那就謝謝你們,讓咱們全家都快樂吧!</s>	joy	joy
<s> 這麼多年了,我沒給你過生日,把日子都忘了,今天借這個機會給你過個生日,長波,咱倆一塊祝願順子生日快樂,身體健康! 好!祝你生日快樂,身體健康! 那就謝謝你們,讓咱們全家都快樂吧! </s></s> 來,全家一塊喝一杯!</s>	joy	joy
<s></s></s> 回來一趟不容易,多住幾天吧。</s>	joy	joy
<s> 回來一趟不容易,多住幾天吧。 </s></s> 回來就別走了,叫我嫂子她們也都來吧。你看這高麗屯不是挺好嗎?這裏住的都是朝鮮人。</s>	joy	joy
<s> 回來一趟不容易,多住幾天吧。 回來就別走了,叫我嫂子她們也都來吧。你看這高麗屯不是挺好嗎?這裏住的都是朝鮮人。 </s></s> 嗯,是挺好,比我來之前想象的好多了。</s>	joy	joy
<s></s></s> 好好吃飯吧!美玉,你沒吃過我做的飯,好吃嗎?</s>	joy	joy
<s> 好好吃飯吧!美玉,你沒吃過我做的飯,好吃嗎? </s></s> 媽媽,您做的飯好吃,我愛吃。</s>	joy	joy
<s> 好好吃飯吧!美玉,你沒吃過我做的飯,好吃嗎? 媽媽,您做的飯好吃,我愛吃。 </s></s> 好吃就好,吃吧,多吃點。</s>	joy	joy
<s></s></s> 哥,有件事我前天沒敢跟你說。回來我想了一夜,覺得還是應該告訴你,告訴順子,如果這次不說,以後怕再也沒有機會了。</s>	fear	fear
<s> 哥,有件事我前天沒敢跟你說。回來我想了一夜,覺得還是應該告訴你,告訴順子,如果這次不說,以後怕再也沒有機會了。 </s></s> 哦,什麼事呀,還不敢說?怕什麼?</s>	surprise	surprise
<s></s></s> 你一扔,可就撿不回來了。</s>	fear	fear
<s> 你一扔,可就撿不回來了。 </s></s> 盡說廢話!扔了還撿他幹啥?</s>	angry	angry
<s> 你一扔,可就撿不回來了。 盡說廢話!扔了還撿他幹啥? </s></s> 可這是你的孩子呀。</s>	angry	sadness
<s> 你一扔,可就撿不回來了。 盡說廢話!扔了還撿他幹啥? 可這是你的孩子呀。 </s></s> 我還不知道這是我的孩子?這是我的孩子,老大不是我的孩子?你就忍心看着老大給人糟蹋?</s>	angry	angry
<s></s></s> 我說順子呀,別哭了,別難過了。長波說孩子還在,那肯定就還在,既然孩子在,就能找到他。不過這件事也不能着急,得慢慢找,慢慢打聽。二十多年過去了,一個襁褓中的孩子,現在可是個大人了。他自己不會知道自己是怎麼來的,不會知道自己的親生爹媽是誰,得在老年人當中打聽。再說,打聽到了,你也認不出來,人家也不一定承認,你說是你的孩子,你有什麼證據?你說是你的孩子,那你爲啥把他扔了?你既然扔了,現在又爲啥往回要?人家會給你嗎?孩子能認你嗎?</s>	sadness	sadness
<s> 我說順子呀,別哭了,別難過了。長波說孩子還在,那肯定就還在,既然孩子在,就能找到他。不過這件事也不能着急,得慢慢找,慢慢打聽。二十多年過去了,一個襁褓中的孩子,現在可是個大人了。他自己不會知道自己是怎麼來的,不會知道自己的親生爹媽是誰,得在老年人當中打聽。再說,打聽到了,你也認不出來,人家也不一定承認,你說是你的孩子,你有什麼證據?你說是你的孩子,那你爲啥把他扔了?你既然扔了,現在又爲啥往回要?人家會給你嗎?孩子能認你嗎? </s></s> 爸爸說得也是。所以媽媽,您別難過了,反正都這麼多年了,這麼多年都過來了。要能找回來更好,找不回來也沒關係,還是自己的身體要緊。</s>	sadness	sadness
<s> 我說順子呀,別哭了,別難過了。長波說孩子還在,那肯定就還在,既然孩子在,就能找到他。不過這件事也不能着急,得慢慢找,慢慢打聽。二十多年過去了,一個襁褓中的孩子,現在可是個大人了。他自己不會知道自己是怎麼來的,不會知道自己的親生爹媽是誰,得在老年人當中打聽。再說,打聽到了,你也認不出來,人家也不一定承認,你說是你的孩子,你有什麼證據?你說是你的孩子,那你爲啥把他扔了?你既然扔了,現在又爲啥往回要?人家會給你嗎?孩子能認你嗎? 爸爸說得也是。所以媽媽,您別難過了,反正都這麼多年了,這麼多年都過來了。要能找回來更好,找不回來也沒關係,還是自己的身體要緊。 </s></s> 我東哥說的對,只要他還在,就一定能找到他,只要找到他,就一定把他帶回來給您看看,不管他承認不承認。</s>	neutral	joy
<s></s></s> 好,走吧。</s>	joy	joy
<s> 好,走吧。 </s></s> 媽媽,我們先走了,您別難過了,我明天再來看您。</s>	joy	joy
<s></s></s> 東哥,這事你就一點都不知道?一點都沒聽說過?</s>	surprise	surprise
<s> 東哥,這事你就一點都不知道?一點都沒聽說過? </s></s> 那時候我在鎮上的小學上學,每天一大早吃了飯就往學校走,中午都不回來,帶着乾糧在教室裏吃,晚上回到家吃了飯就睡覺,家裏的事根本就不知道。</s>	neutral	sadness
<s> 東哥,這事你就一點都不知道?一點都沒聽說過? 那時候我在鎮上的小學上學,每天一大早吃了飯就往學校走,中午都不回來,帶着乾糧在教室裏吃,晚上回到家吃了飯就睡覺,家裏的事根本就不知道。 </s></s> 也難怪,順子的事她自己都不知道,知道的就長波一個人,他自己不說誰還能知道?</s>	surprise	sadness
<s> 東哥,這事你就一點都不知道?一點都沒聽說過? 那時候我在鎮上的小學上學,每天一大早吃了飯就往學校走,中午都不回來,帶着乾糧在教室裏吃,晚上回到家吃了飯就睡覺,家裏的事根本就不知道。 也難怪,順子的事她自己都不知道,知道的就長波一個人,他自己不說誰還能知道? </s></s> 可不是唄,別說小孩子的事了,就連我有個大爺在國外這麼大的事,我都不知道。我爸媽的嘴可嚴了。</s>	disgust	surprise
<s> 東哥,這事你就一點都不知道?一點都沒聽說過? 那時候我在鎮上的小學上學,每天一大早吃了飯就往學校走,中午都不回來,帶着乾糧在教室裏吃,晚上回到家吃了飯就睡覺,家裏的事根本就不知道。 也難怪,順子的事她自己都不知道,知道的就長波一個人,他自己不說誰還能知道? 可不是唄,別說小孩子的事了,就連我有個大爺在國外這麼大的事,我都不知道。我爸媽的嘴可嚴了。 </s></s> 看來你爸說的是真的。他是不會編瞎話的,他也編不出這麼離奇的故事。今天既然說出來了,你們就幫忙找一找吧。</s>	neutral	joy
<s> 東哥,這事你就一點都不知道?一點都沒聽說過? 那時候我在鎮上的小學上學,每天一大早吃了飯就往學校走,中午都不回來,帶着乾糧在教室裏吃,晚上回到家吃了飯就睡覺,家裏的事根本就不知道。 也難怪,順子的事她自己都不知道,知道的就長波一個人,他自己不說誰還能知道? 可不是唄,別說小孩子的事了,就連我有個大爺在國外這麼大的事,我都不知道。我爸媽的嘴可嚴了。 看來你爸說的是真的。他是不會編瞎話的,他也編不出這麼離奇的故事。今天既然說出來了,你們就幫忙找一找吧。 </s></s> 行,我明天就去找馬軍,還有我們的朋友,分頭去打聽。</s>	neutral	joy
<s> 東哥,這事你就一點都不知道?一點都沒聽說過? 那時候我在鎮上的小學上學,每天一大早吃了飯就往學校走,中午都不回來,帶着乾糧在教室裏吃,晚上回到家吃了飯就睡覺,家裏的事根本就不知道。 也難怪,順子的事她自己都不知道,知道的就長波一個人,他自己不說誰還能知道? 可不是唄,別說小孩子的事了,就連我有個大爺在國外這麼大的事,我都不知道。我爸媽的嘴可嚴了。 看來你爸說的是真的。他是不會編瞎話的,他也編不出這麼離奇的故事。今天既然說出來了,你們就幫忙找一找吧。 行,我明天就去找馬軍,還有我們的朋友,分頭去打聽。 </s></s> 馬軍是誰?</s>	surprise	surprise
<s> 東哥,這事你就一點都不知道?一點都沒聽說過? 那時候我在鎮上的小學上學,每天一大早吃了飯就往學校走,中午都不回來,帶着乾糧在教室裏吃,晚上回到家吃了飯就睡覺,家裏的事根本就不知道。 也難怪,順子的事她自己都不知道,知道的就長波一個人,他自己不說誰還能知道? 可不是唄,別說小孩子的事了,就連我有個大爺在國外這麼大的事,我都不知道。我爸媽的嘴可嚴了。 看來你爸說的是真的。他是不會編瞎話的,他也編不出這麼離奇的故事。今天既然說出來了,你們就幫忙找一找吧。 行,我明天就去找馬軍,還有我們的朋友,分頭去打聽。 馬軍是誰? </s></s> 馬軍就是馬廠長的孫子。馬軍他爺爺他爸爸都是林業局的老人,他們認識的人多。</s>	neutral	joy
<s> 東哥,這事你就一點都不知道?一點都沒聽說過? 那時候我在鎮上的小學上學,每天一大早吃了飯就往學校走,中午都不回來,帶着乾糧在教室裏吃,晚上回到家吃了飯就睡覺,家裏的事根本就不知道。 也難怪,順子的事她自己都不知道,知道的就長波一個人,他自己不說誰還能知道? 可不是唄,別說小孩子的事了,就連我有個大爺在國外這麼大的事,我都不知道。我爸媽的嘴可嚴了。 看來你爸說的是真的。他是不會編瞎話的,他也編不出這麼離奇的故事。今天既然說出來了,你們就幫忙找一找吧。 行,我明天就去找馬軍,還有我們的朋友,分頭去打聽。 馬軍是誰? 馬軍就是馬廠長的孫子。馬軍他爺爺他爸爸都是林業局的老人,他們認識的人多。 </s></s> 好,這個辦法好。</s>	neutral	joy
<s></s></s> 韓東,你進來一下,我想跟你們商量個事情。</s>	neutral	neutral
<s> 韓東,你進來一下,我想跟你們商量個事情。 </s></s> 好吧大爺。</s>	neutral	neutral
<s></s></s> 您怎麼幫他們呀,誰都不認識?</s>	surprise	surprise
<s> 您怎麼幫他們呀,誰都不認識? </s></s> 怎麼誰都不認識?我不是認識馬廠長嗎?他不是我的老上級嗎?</s>	surprise	surprise
<s> 您怎麼幫他們呀,誰都不認識? 怎麼誰都不認識?我不是認識馬廠長嗎?他不是我的老上級嗎? </s></s> 對呀,您和馬廠長說說,他不會不幫忙的,他認識的老人也多。</s>	neutral	joy
<s> 您怎麼幫他們呀,誰都不認識? 怎麼誰都不認識?我不是認識馬廠長嗎?他不是我的老上級嗎? 對呀,您和馬廠長說說,他不會不幫忙的,他認識的老人也多。 </s></s> “所以呀,我想請他們來吃頓飯,一來是,我離鄉背井四十年,回來之後看到親人們生活得都挺好,我心裏很高興。俗話說遠親不如近鄰嘛。這些年來多虧了鄉親們幫忙照顧,你母親她們才能克服生活上的許多困難。我回來之後,他們又對我熱情接待,我想藉此機會表達一下我的感激之情。</s>	joy	joy
<s></s></s> 爸爸想得真周到。</s>	joy	joy
<s> 爸爸想得真周到。 </s></s> 二來呢,是長波和順子他們孩子的事,請他們幫忙打聽打聽,他們肯定能提供一些線索。</s>	neutral	joy
<s></s></s> 您準備請誰呀?馬廠長,還有呢?</s>	surprise	surprise
<s> 您準備請誰呀?馬廠長,還有呢? </s></s> 除了馬廠長還有兩個人,就是鎮上的李鎮長和賓館的王經理。他們對我一直都是很熱情很照顧的。</s>	joy	joy
<s> 您準備請誰呀?馬廠長,還有呢? 除了馬廠長還有兩個人,就是鎮上的李鎮長和賓館的王經理。他們對我一直都是很熱情很照顧的。 </s></s> 要提孩子的事,我媽我爸他們最好也在場,別人怕說不清楚。</s>	neutral	neutral
<s></s></s> 請客的時候,把馬軍也叫來吧?</s>	joy	joy
<s> 請客的時候,把馬軍也叫來吧? </s></s> 就是馬廠長的孫子?</s>	surprise	surprise
<s> 請客的時候,把馬軍也叫來吧? 就是馬廠長的孫子? </s></s> 是呀,馬軍是東哥的好朋友,</s>	joy	joy
<s> 請客的時候,把馬軍也叫來吧? 就是馬廠長的孫子? 是呀,馬軍是東哥的好朋友, </s></s> 好啊!我的朋友、你們的朋友都來。</s>	joy	joy
<s></s></s> 好吧,就這樣,今天大爺累了,早點休息吧,我回去了。</s>	neutral	joy
<s> 好吧,就這樣,今天大爺累了,早點休息吧,我回去了。 </s></s> 好吧,我送你。</s>	neutral	joy
<s></s></s> 大爺再見!</s>	joy	joy
<s> 大爺再見! </s></s> 你明天就去找馬軍嗎?</s>	neutral	surprise
<s></s></s> 是呀,事不宜遲。你們的時間不是很少嗎?</s>	neutral	surprise
<s> 是呀,事不宜遲。你們的時間不是很少嗎? </s></s> 你啥時候去?我想跟你一塊去。</s>	joy	joy
<s></s></s> 行,我吃完早飯就來接你。</s>	joy	joy
<s> 行,我吃完早飯就來接你。 </s></s> 上哪兒去找呀?</s>	surprise	surprise
<s> 行,我吃完早飯就來接你。 上哪兒去找呀? </s></s> 上青河,他們肯定都在那。</s>	joy	joy
<s> 行,我吃完早飯就來接你。 上哪兒去找呀? 上青河,他們肯定都在那。 </s></s> 就是有小火車的那個地方?</s>	surprise	surprise
<s> 行,我吃完早飯就來接你。 上哪兒去找呀? 上青河,他們肯定都在那。 就是有小火車的那個地方? </s></s> 對呀,咱們不是去過嗎?</s>	joy	surprise
<s> 行,我吃完早飯就來接你。 上哪兒去找呀? 上青河,他們肯定都在那。 就是有小火車的那個地方? 對呀,咱們不是去過嗎? </s></s> 太好了!我挺喜歡那裏的。</s>	joy	joy
<s> 行,我吃完早飯就來接你。 上哪兒去找呀? 上青河,他們肯定都在那。 就是有小火車的那個地方? 對呀,咱們不是去過嗎? 太好了!我挺喜歡那裏的。 </s></s> 好吧,我走了。</s>	joy	joy
<s> 行,我吃完早飯就來接你。 上哪兒去找呀? 上青河,他們肯定都在那。 就是有小火車的那個地方? 對呀,咱們不是去過嗎? 太好了!我挺喜歡那裏的。 好吧,我走了。 </s></s> 東哥再見!</s>	joy	joy
<s> 行,我吃完早飯就來接你。 上哪兒去找呀? 上青河,他們肯定都在那。 就是有小火車的那個地方? 對呀,咱們不是去過嗎? 太好了!我挺喜歡那裏的。 好吧,我走了。 東哥再見! </s></s> 再見!</s>	joy	joy
<s></s></s> 二十二年前?一個孩子?還活着?</s>	surprise	surprise
<s> 二十二年前?一個孩子?還活着? </s></s> 還有一個孩子?</s>	surprise	surprise
<s> 二十二年前?一個孩子?還活着? 還有一個孩子? </s></s> 怎麼回事?快說說!</s>	surprise	surprise
<s> 二十二年前?一個孩子?還活着? 還有一個孩子? 怎麼回事?快說說! </s></s> 我爸說,二十二年前,我媽還生過一個孩子,可是他們不敢要這個孩子,就扔了。是我媽叫我爸出去扔的,叫他扔到山上去。可是我爸沒扔,他捨不得,就趁着半夜把這個孩子擱到醫院的長椅子上了。他想,誰願意要誰就撿去吧,只要孩子活着,不餵了野牲口就行。結果孩子還真被人撿走了,沒死。</s>	sadness	neutral
<s> 二十二年前?一個孩子?還活着? 還有一個孩子? 怎麼回事?快說說! 我爸說,二十二年前,我媽還生過一個孩子,可是他們不敢要這個孩子,就扔了。是我媽叫我爸出去扔的,叫他扔到山上去。可是我爸沒扔,他捨不得,就趁着半夜把這個孩子擱到醫院的長椅子上了。他想,誰願意要誰就撿去吧,只要孩子活着,不餵了野牲口就行。結果孩子還真被人撿走了,沒死。 </s></s> 還有這樣的事兒?真奇了!</s>	surprise	surprise
<s> 二十二年前?一個孩子?還活着? 還有一個孩子? 怎麼回事?快說說! 我爸說,二十二年前,我媽還生過一個孩子,可是他們不敢要這個孩子,就扔了。是我媽叫我爸出去扔的,叫他扔到山上去。可是我爸沒扔,他捨不得,就趁着半夜把這個孩子擱到醫院的長椅子上了。他想,誰願意要誰就撿去吧,只要孩子活着,不餵了野牲口就行。結果孩子還真被人撿走了,沒死。 還有這樣的事兒?真奇了! </s></s> 你爸怎麼知道孩子給人撿走了,他看見了?</s>	surprise	surprise
<s> 二十二年前?一個孩子?還活着? 還有一個孩子? 怎麼回事?快說說! 我爸說,二十二年前,我媽還生過一個孩子,可是他們不敢要這個孩子,就扔了。是我媽叫我爸出去扔的,叫他扔到山上去。可是我爸沒扔,他捨不得,就趁着半夜把這個孩子擱到醫院的長椅子上了。他想,誰願意要誰就撿去吧,只要孩子活着,不餵了野牲口就行。結果孩子還真被人撿走了,沒死。 還有這樣的事兒?真奇了! 你爸怎麼知道孩子給人撿走了,他看見了? </s></s> 當時是半夜,他沒看見。第二天一大早他就到醫院去看,椅子上那個孩子不見了,他想肯定是被人抱走了,也就沒再問這件事。後來,他在村裏碰上幾個老頭閒嘮嗑,其中一個老頭說,有人在醫院住院的時候,看見一個人在走廊的椅子上撿回了一個孩子。他這纔想到,那個被撿回去的孩子可能就是自己扔的孩子。他回頭去問那個老頭,那個老頭又矢口否認了,說他什麼也沒說,什麼也不知道,後來沒多久,那個老頭就死了。</s>	sadness	neutral
<s> 二十二年前?一個孩子?還活着? 還有一個孩子? 怎麼回事?快說說! 我爸說,二十二年前,我媽還生過一個孩子,可是他們不敢要這個孩子,就扔了。是我媽叫我爸出去扔的,叫他扔到山上去。可是我爸沒扔,他捨不得,就趁着半夜把這個孩子擱到醫院的長椅子上了。他想,誰願意要誰就撿去吧,只要孩子活着,不餵了野牲口就行。結果孩子還真被人撿走了,沒死。 還有這樣的事兒?真奇了! 你爸怎麼知道孩子給人撿走了,他看見了? 當時是半夜,他沒看見。第二天一大早他就到醫院去看,椅子上那個孩子不見了,他想肯定是被人抱走了,也就沒再問這件事。後來,他在村裏碰上幾個老頭閒嘮嗑,其中一個老頭說,有人在醫院住院的時候,看見一個人在走廊的椅子上撿回了一個孩子。他這纔想到,那個被撿回去的孩子可能就是自己扔的孩子。他回頭去問那個老頭,那個老頭又矢口否認了,說他什麼也沒說,什麼也不知道,後來沒多久,那個老頭就死了。 </s></s> 死無對證了。</s>	angry	sadness
<s> 二十二年前?一個孩子?還活着? 還有一個孩子? 怎麼回事?快說說! 我爸說,二十二年前,我媽還生過一個孩子,可是他們不敢要這個孩子,就扔了。是我媽叫我爸出去扔的,叫他扔到山上去。可是我爸沒扔,他捨不得,就趁着半夜把這個孩子擱到醫院的長椅子上了。他想,誰願意要誰就撿去吧,只要孩子活着,不餵了野牲口就行。結果孩子還真被人撿走了,沒死。 還有這樣的事兒?真奇了! 你爸怎麼知道孩子給人撿走了,他看見了? 當時是半夜,他沒看見。第二天一大早他就到醫院去看,椅子上那個孩子不見了,他想肯定是被人抱走了,也就沒再問這件事。後來,他在村裏碰上幾個老頭閒嘮嗑,其中一個老頭說,有人在醫院住院的時候,看見一個人在走廊的椅子上撿回了一個孩子。他這纔想到,那個被撿回去的孩子可能就是自己扔的孩子。他回頭去問那個老頭,那個老頭又矢口否認了,說他什麼也沒說,什麼也不知道,後來沒多久,那個老頭就死了。 死無對證了。 </s></s> 可不唄。</s>	neutral	sadness
<s> 二十二年前?一個孩子?還活着? 還有一個孩子? 怎麼回事?快說說! 我爸說,二十二年前,我媽還生過一個孩子,可是他們不敢要這個孩子,就扔了。是我媽叫我爸出去扔的,叫他扔到山上去。可是我爸沒扔,他捨不得,就趁着半夜把這個孩子擱到醫院的長椅子上了。他想,誰願意要誰就撿去吧,只要孩子活着,不餵了野牲口就行。結果孩子還真被人撿走了,沒死。 還有這樣的事兒?真奇了! 你爸怎麼知道孩子給人撿走了,他看見了? 當時是半夜,他沒看見。第二天一大早他就到醫院去看,椅子上那個孩子不見了,他想肯定是被人抱走了,也就沒再問這件事。後來,他在村裏碰上幾個老頭閒嘮嗑,其中一個老頭說,有人在醫院住院的時候,看見一個人在走廊的椅子上撿回了一個孩子。他這纔想到,那個被撿回去的孩子可能就是自己扔的孩子。他回頭去問那個老頭,那個老頭又矢口否認了,說他什麼也沒說,什麼也不知道,後來沒多久,那個老頭就死了。 死無對證了。 可不唄。 </s></s> 是男孩還是女孩?</s>	surprise	surprise
<s> 二十二年前?一個孩子?還活着? 還有一個孩子? 怎麼回事?快說說! 我爸說,二十二年前,我媽還生過一個孩子,可是他們不敢要這個孩子,就扔了。是我媽叫我爸出去扔的,叫他扔到山上去。可是我爸沒扔,他捨不得,就趁着半夜把這個孩子擱到醫院的長椅子上了。他想,誰願意要誰就撿去吧,只要孩子活着,不餵了野牲口就行。結果孩子還真被人撿走了,沒死。 還有這樣的事兒?真奇了! 你爸怎麼知道孩子給人撿走了,他看見了? 當時是半夜,他沒看見。第二天一大早他就到醫院去看,椅子上那個孩子不見了,他想肯定是被人抱走了,也就沒再問這件事。後來,他在村裏碰上幾個老頭閒嘮嗑,其中一個老頭說,有人在醫院住院的時候,看見一個人在走廊的椅子上撿回了一個孩子。他這纔想到,那個被撿回去的孩子可能就是自己扔的孩子。他回頭去問那個老頭,那個老頭又矢口否認了,說他什麼也沒說,什麼也不知道,後來沒多久,那個老頭就死了。 死無對證了。 可不唄。 是男孩還是女孩? </s></s> 是男孩。</s>	neutral	neutral
<s> 還有一個孩子? 怎麼回事?快說說! 我爸說,二十二年前,我媽還生過一個孩子,可是他們不敢要這個孩子,就扔了。是我媽叫我爸出去扔的,叫他扔到山上去。可是我爸沒扔,他捨不得,就趁着半夜把這個孩子擱到醫院的長椅子上了。他想,誰願意要誰就撿去吧,只要孩子活着,不餵了野牲口就行。結果孩子還真被人撿走了,沒死。 還有這樣的事兒?真奇了! 你爸怎麼知道孩子給人撿走了,他看見了? 當時是半夜,他沒看見。第二天一大早他就到醫院去看,椅子上那個孩子不見了,他想肯定是被人抱走了,也就沒再問這件事。後來,他在村裏碰上幾個老頭閒嘮嗑,其中一個老頭說,有人在醫院住院的時候,看見一個人在走廊的椅子上撿回了一個孩子。他這纔想到,那個被撿回去的孩子可能就是自己扔的孩子。他回頭去問那個老頭,那個老頭又矢口否認了,說他什麼也沒說,什麼也不知道,後來沒多久,那個老頭就死了。 死無對證了。 可不唄。 是男孩還是女孩? 是男孩。 </s></s> 太好了!要是那個孩子還在的話,你們一定要想辦法把他找到。</s>	joy	joy
<s></s></s> 那就趕快找呀?</s>	surprise	surprise
<s> 那就趕快找呀? </s></s> 她又不是住院生的,是扔在醫院走廊裏的,醫院怎麼會有記錄呢?</s>	surprise	surprise
<s> 那就趕快找呀? 她又不是住院生的,是扔在醫院走廊裏的,醫院怎麼會有記錄呢? </s></s> 不是找她。她生孩子當然沒有記錄。是找那幾個當時住院的人。他們不是看見有人撿孩子了嗎?</s>	surprise	surprise
<s> 那就趕快找呀? 她又不是住院生的,是扔在醫院走廊裏的,醫院怎麼會有記錄呢? 不是找她。她生孩子當然沒有記錄。是找那幾個當時住院的人。他們不是看見有人撿孩子了嗎? </s></s> 對,這樣行。</s>	neutral	joy
<s></s></s> 我說你也可以上派出所去問一下,請他們給查一下檔案,二十二年前的那段時間,有什麼人來報過戶口?一個男孩,姓什麼,叫什麼,這也是一條線索。</s>	neutral	neutral
<s> 我說你也可以上派出所去問一下,請他們給查一下檔案,二十二年前的那段時間,有什麼人來報過戶口?一個男孩,姓什麼,叫什麼,這也是一條線索。 </s></s> 對,這也是個辦法。</s>	joy	joy
<s></s></s> 可以,我這就去。</s>	joy	joy
<s> 可以,我這就去。 </s></s> 我跟你一塊去。</s>	joy	joy
<s></s></s> 這本來是個平平常常的山包,就因爲在山上蓋了這個紅磚房,才有了小紅山這個名兒。</s>	joy	joy
<s> 這本來是個平平常常的山包,就因爲在山上蓋了這個紅磚房,才有了小紅山這個名兒。 </s></s> 挺好嘛。這個紅磚房是誰蓋的呀?</s>	joy	joy
<s> 這本來是個平平常常的山包,就因爲在山上蓋了這個紅磚房,才有了小紅山這個名兒。 挺好嘛。這個紅磚房是誰蓋的呀? </s></s> 聽說是鐵路上的人蓋的。</s>	joy	neutral
<s> 這本來是個平平常常的山包,就因爲在山上蓋了這個紅磚房,才有了小紅山這個名兒。 挺好嘛。這個紅磚房是誰蓋的呀? 聽說是鐵路上的人蓋的。 </s></s> 住在這裏可不錯。</s>	joy	joy
<s></s></s> 從這看下去真是太好了。</s>	joy	joy
<s> 從這看下去真是太好了。 </s></s> 滑雪場我們去過了。</s>	neutral	joy
<s> 從這看下去真是太好了。 滑雪場我們去過了。 </s></s> 那我也上不去,上這個小紅山,我都累得不行了。咱們找個地方歇歇吧。</s>	joy	neutral
<s> 從這看下去真是太好了。 滑雪場我們去過了。 那我也上不去,上這個小紅山,我都累得不行了。咱們找個地方歇歇吧。 </s></s> 好吧,歇歇吧,我也累了。</s>	neutral	joy
<s></s></s> 來,咱們在這坐一會吧。</s>	joy	neutral
<s> 來,咱們在這坐一會吧。 </s></s> 在景陽鎮住了幾十年,我還沒上過這個小紅山呢。</s>	neutral	surprise
<s> 來,咱們在這坐一會吧。 在景陽鎮住了幾十年,我還沒上過這個小紅山呢。 </s></s> 我也很少上來,沒事誰上這來呀?</s>	surprise	surprise
<s> 來,咱們在這坐一會吧。 在景陽鎮住了幾十年,我還沒上過這個小紅山呢。 我也很少上來,沒事誰上這來呀? </s></s> 除了這個紅磚房,再沒有別的房子了嗎?</s>	disgust	surprise
<s> 來,咱們在這坐一會吧。 在景陽鎮住了幾十年,我還沒上過這個小紅山呢。 我也很少上來,沒事誰上這來呀? 除了這個紅磚房,再沒有別的房子了嗎? </s></s> 有,那後邊有一大片呢,這是景陽鎮的一個村。</s>	joy	joy
<s> 來,咱們在這坐一會吧。 在景陽鎮住了幾十年,我還沒上過這個小紅山呢。 我也很少上來,沒事誰上這來呀? 除了這個紅磚房,再沒有別的房子了嗎? 有,那後邊有一大片呢,這是景陽鎮的一個村。 </s></s> 住在這裏也不錯,就是上下山太麻煩,累人。</s>	neutral	disgust
<s> 來,咱們在這坐一會吧。 在景陽鎮住了幾十年,我還沒上過這個小紅山呢。 我也很少上來,沒事誰上這來呀? 除了這個紅磚房,再沒有別的房子了嗎? 有,那後邊有一大片呢,這是景陽鎮的一個村。 住在這裏也不錯,就是上下山太麻煩,累人。 </s></s> 住習慣了也沒啥,就跟住樓房上樓梯一樣。</s>	neutral	neutral
<s> 來,咱們在這坐一會吧。 在景陽鎮住了幾十年,我還沒上過這個小紅山呢。 我也很少上來,沒事誰上這來呀? 除了這個紅磚房,再沒有別的房子了嗎? 有,那後邊有一大片呢,這是景陽鎮的一個村。 住在這裏也不錯,就是上下山太麻煩,累人。 住習慣了也沒啥,就跟住樓房上樓梯一樣。 </s></s> 這山上吃水咋辦呀,也得上螞蟻河去挑嗎?</s>	joy	fear
<s> 來,咱們在這坐一會吧。 在景陽鎮住了幾十年,我還沒上過這個小紅山呢。 我也很少上來,沒事誰上這來呀? 除了這個紅磚房,再沒有別的房子了嗎? 有,那後邊有一大片呢,這是景陽鎮的一個村。 住在這裏也不錯,就是上下山太麻煩,累人。 住習慣了也沒啥,就跟住樓房上樓梯一樣。 這山上吃水咋辦呀,也得上螞蟻河去挑嗎? </s></s> 不用,這裏有井水。</s>	joy	neutral
<s> 來,咱們在這坐一會吧。 在景陽鎮住了幾十年,我還沒上過這個小紅山呢。 我也很少上來,沒事誰上這來呀? 除了這個紅磚房,再沒有別的房子了嗎? 有,那後邊有一大片呢,這是景陽鎮的一個村。 住在這裏也不錯,就是上下山太麻煩,累人。 住習慣了也沒啥,就跟住樓房上樓梯一樣。 這山上吃水咋辦呀,也得上螞蟻河去挑嗎? 不用,這裏有井水。 </s></s> 這裏有朝鮮人嗎?</s>	surprise	surprise
<s> 來,咱們在這坐一會吧。 在景陽鎮住了幾十年,我還沒上過這個小紅山呢。 我也很少上來,沒事誰上這來呀? 除了這個紅磚房,再沒有別的房子了嗎? 有,那後邊有一大片呢,這是景陽鎮的一個村。 住在這裏也不錯,就是上下山太麻煩,累人。 住習慣了也沒啥,就跟住樓房上樓梯一樣。 這山上吃水咋辦呀,也得上螞蟻河去挑嗎? 不用,這裏有井水。 這裏有朝鮮人嗎? </s></s> 可能沒有,朝鮮人都在高麗屯。</s>	neutral	neutral
<s> 在景陽鎮住了幾十年,我還沒上過這個小紅山呢。 我也很少上來,沒事誰上這來呀? 除了這個紅磚房,再沒有別的房子了嗎? 有,那後邊有一大片呢,這是景陽鎮的一個村。 住在這裏也不錯,就是上下山太麻煩,累人。 住習慣了也沒啥,就跟住樓房上樓梯一樣。 這山上吃水咋辦呀,也得上螞蟻河去挑嗎? 不用,這裏有井水。 這裏有朝鮮人嗎? 可能沒有,朝鮮人都在高麗屯。 </s></s> 那還是住在高麗屯好。</s>	joy	neutral
<s> 我也很少上來,沒事誰上這來呀? 除了這個紅磚房,再沒有別的房子了嗎? 有,那後邊有一大片呢,這是景陽鎮的一個村。 住在這裏也不錯,就是上下山太麻煩,累人。 住習慣了也沒啥,就跟住樓房上樓梯一樣。 這山上吃水咋辦呀,也得上螞蟻河去挑嗎? 不用,這裏有井水。 這裏有朝鮮人嗎? 可能沒有,朝鮮人都在高麗屯。 那還是住在高麗屯好。 </s></s> 媽媽,坐一會咱們就下去吧,快到吃飯的時間了。</s>	joy	neutral
<s> 除了這個紅磚房,再沒有別的房子了嗎? 有,那後邊有一大片呢,這是景陽鎮的一個村。 住在這裏也不錯,就是上下山太麻煩,累人。 住習慣了也沒啥,就跟住樓房上樓梯一樣。 這山上吃水咋辦呀,也得上螞蟻河去挑嗎? 不用,這裏有井水。 這裏有朝鮮人嗎? 可能沒有,朝鮮人都在高麗屯。 那還是住在高麗屯好。 媽媽,坐一會咱們就下去吧,快到吃飯的時間了。 </s></s> 非得去吃飯嗎?</s>	surprise	disgust
<s> 有,那後邊有一大片呢,這是景陽鎮的一個村。 住在這裏也不錯,就是上下山太麻煩,累人。 住習慣了也沒啥,就跟住樓房上樓梯一樣。 這山上吃水咋辦呀,也得上螞蟻河去挑嗎? 不用,這裏有井水。 這裏有朝鮮人嗎? 可能沒有,朝鮮人都在高麗屯。 那還是住在高麗屯好。 媽媽,坐一會咱們就下去吧,快到吃飯的時間了。 非得去吃飯嗎? </s></s> 去吧。爸爸請客,咱們咋能不去呢?</s>	joy	surprise
<s> 住在這裏也不錯,就是上下山太麻煩,累人。 住習慣了也沒啥,就跟住樓房上樓梯一樣。 這山上吃水咋辦呀,也得上螞蟻河去挑嗎? 不用,這裏有井水。 這裏有朝鮮人嗎? 可能沒有,朝鮮人都在高麗屯。 那還是住在高麗屯好。 媽媽,坐一會咱們就下去吧,快到吃飯的時間了。 非得去吃飯嗎? 去吧。爸爸請客,咱們咋能不去呢? </s></s> 他都請了些啥客呀?</s>	surprise	surprise
<s> 住習慣了也沒啥,就跟住樓房上樓梯一樣。 這山上吃水咋辦呀,也得上螞蟻河去挑嗎? 不用,這裏有井水。 這裏有朝鮮人嗎? 可能沒有,朝鮮人都在高麗屯。 那還是住在高麗屯好。 媽媽,坐一會咱們就下去吧,快到吃飯的時間了。 非得去吃飯嗎? 去吧。爸爸請客,咱們咋能不去呢? 他都請了些啥客呀? </s></s> 主要還是咱們家的人,還有馬廠長。聽我爸說,馬廠長是爸的老上司。當年我爸在廠裏幹活,馬廠長就是廠長。這次我們回來,第一個見到的熟人就是馬廠長。還有鎮上的領導。他們都給我們幫了挺大的忙。</s>	joy	joy
<s> 這山上吃水咋辦呀,也得上螞蟻河去挑嗎? 不用,這裏有井水。 這裏有朝鮮人嗎? 可能沒有,朝鮮人都在高麗屯。 那還是住在高麗屯好。 媽媽,坐一會咱們就下去吧,快到吃飯的時間了。 非得去吃飯嗎? 去吧。爸爸請客,咱們咋能不去呢? 他都請了些啥客呀? 主要還是咱們家的人,還有馬廠長。聽我爸說,馬廠長是爸的老上司。當年我爸在廠裏幹活,馬廠長就是廠長。這次我們回來,第一個見到的熟人就是馬廠長。還有鎮上的領導。他們都給我們幫了挺大的忙。 </s></s> 都是領導,還叫咱們去幹啥?</s>	surprise	disgust
<s></s></s> 怎麼,剛來了幾天就要走了?</s>	surprise	surprise
<s> 怎麼,剛來了幾天就要走了? </s></s> 時間不短了,在外面覺得很累,孩子還得上學。</s>	joy	sadness
<s> 怎麼,剛來了幾天就要走了? 時間不短了,在外面覺得很累,孩子還得上學。 </s></s> 住在這裏還習慣吧?</s>	neutral	surprise
<s> 怎麼,剛來了幾天就要走了? 時間不短了,在外面覺得很累,孩子還得上學。 住在這裏還習慣吧? </s></s> 習慣,這裏條件很好,服務也很周到。</s>	joy	joy
<s> 怎麼,剛來了幾天就要走了? 時間不短了,在外面覺得很累,孩子還得上學。 住在這裏還習慣吧? 習慣,這裏條件很好,服務也很周到。 </s></s> 一走四十年,這次回來和親人團聚,不容易。</s>	neutral	joy
<s> 怎麼,剛來了幾天就要走了? 時間不短了,在外面覺得很累,孩子還得上學。 住在這裏還習慣吧? 習慣,這裏條件很好,服務也很周到。 一走四十年,這次回來和親人團聚,不容易。 </s></s> 是呀。要知道這邊這麼好,早該回來看看。</s>	joy	joy
<s> 怎麼,剛來了幾天就要走了? 時間不短了,在外面覺得很累,孩子還得上學。 住在這裏還習慣吧? 習慣,這裏條件很好,服務也很周到。 一走四十年,這次回來和親人團聚,不容易。 是呀。要知道這邊這麼好,早該回來看看。 </s></s> 是呀,早該回來。</s>	joy	joy
<s> 怎麼,剛來了幾天就要走了? 時間不短了,在外面覺得很累,孩子還得上學。 住在這裏還習慣吧? 習慣,這裏條件很好,服務也很周到。 一走四十年,這次回來和親人團聚,不容易。 是呀。要知道這邊這麼好,早該回來看看。 是呀,早該回來。 </s></s> 現在也不晚。再說,早幾年也沒條件,想回也回不來。</s>	sadness	sadness
<s> 怎麼,剛來了幾天就要走了? 時間不短了,在外面覺得很累,孩子還得上學。 住在這裏還習慣吧? 習慣,這裏條件很好,服務也很周到。 一走四十年,這次回來和親人團聚,不容易。 是呀。要知道這邊這麼好,早該回來看看。 是呀,早該回來。 現在也不晚。再說,早幾年也沒條件,想回也回不來。 </s></s> 現在好了,旅遊的多了,都能出國旅遊了。</s>	joy	joy
<s> 怎麼,剛來了幾天就要走了? 時間不短了,在外面覺得很累,孩子還得上學。 住在這裏還習慣吧? 習慣,這裏條件很好,服務也很周到。 一走四十年,這次回來和親人團聚,不容易。 是呀。要知道這邊這麼好,早該回來看看。 是呀,早該回來。 現在也不晚。再說,早幾年也沒條件,想回也回不來。 現在好了,旅遊的多了,都能出國旅遊了。 </s></s> 對,以後想啥時候來就啥時候來,韓國離這裏也不遠。</s>	joy	joy
<s> 怎麼,剛來了幾天就要走了? 時間不短了,在外面覺得很累,孩子還得上學。 住在這裏還習慣吧? 習慣,這裏條件很好,服務也很周到。 一走四十年,這次回來和親人團聚,不容易。 是呀。要知道這邊這麼好,早該回來看看。 是呀,早該回來。 現在也不晚。再說,早幾年也沒條件,想回也回不來。 現在好了,旅遊的多了,都能出國旅遊了。 對,以後想啥時候來就啥時候來,韓國離這裏也不遠。 </s></s> 是,是。</s>	neutral	joy
<s></s></s> 今天總共有幾個客人呀?椅子夠嗎?</s>	surprise	fear
<s> 今天總共有幾個客人呀?椅子夠嗎? </s></s> 我算算,韓東和他爸他媽,美玉和她爸,還有李鎮長、王經理、我爺爺,八個了。</s>	neutral	neutral
<s> 今天總共有幾個客人呀?椅子夠嗎? 我算算,韓東和他爸他媽,美玉和她爸,還有李鎮長、王經理、我爺爺,八個了。 </s></s> 你爸不來嗎?</s>	surprise	surprise
<s> 今天總共有幾個客人呀?椅子夠嗎? 我算算,韓東和他爸他媽,美玉和她爸,還有李鎮長、王經理、我爺爺,八個了。 你爸不來嗎? </s></s> 得來吧?九個,還有咱們倆,十一個。</s>	joy	neutral
<s> 今天總共有幾個客人呀?椅子夠嗎? 我算算,韓東和他爸他媽,美玉和她爸,還有李鎮長、王經理、我爺爺,八個了。 你爸不來嗎? 得來吧?九個,還有咱們倆,十一個。 </s></s> 咱們倆還來嗎?</s>	surprise	surprise
<s> 今天總共有幾個客人呀?椅子夠嗎? 我算算,韓東和他爸他媽,美玉和她爸,還有李鎮長、王經理、我爺爺,八個了。 你爸不來嗎? 得來吧?九個,還有咱們倆,十一個。 咱們倆還來嗎? </s></s> 怎麼不來?不是已經來了嗎?</s>	surprise	surprise
<s> 今天總共有幾個客人呀?椅子夠嗎? 我算算,韓東和他爸他媽,美玉和她爸,還有李鎮長、王經理、我爺爺,八個了。 你爸不來嗎? 得來吧?九個,還有咱們倆,十一個。 咱們倆還來嗎? 怎麼不來?不是已經來了嗎? </s></s> 我是說,咱們還上桌嗎?</s>	surprise	surprise
<s> 今天總共有幾個客人呀?椅子夠嗎? 我算算,韓東和他爸他媽,美玉和她爸,還有李鎮長、王經理、我爺爺,八個了。 你爸不來嗎? 得來吧?九個,還有咱們倆,十一個。 咱們倆還來嗎? 怎麼不來?不是已經來了嗎? 我是說,咱們還上桌嗎? </s></s> 得上呀,韓東肯定希望咱們跟他在一起嘛。</s>	joy	joy
<s> 今天總共有幾個客人呀?椅子夠嗎? 我算算,韓東和他爸他媽,美玉和她爸,還有李鎮長、王經理、我爺爺,八個了。 你爸不來嗎? 得來吧?九個,還有咱們倆,十一個。 咱們倆還來嗎? 怎麼不來?不是已經來了嗎? 我是說,咱們還上桌嗎? 得上呀,韓東肯定希望咱們跟他在一起嘛。 </s></s> 那總共十一個,椅子夠了。</s>	joy	neutral
<s></s></s> 不用介紹了,大家可能都知道,這是我們勞動服務公司總經理馬寶林,馬總。</s>	neutral	joy
<s> 不用介紹了,大家可能都知道,這是我們勞動服務公司總經理馬寶林,馬總。 </s></s> 本公司雖然有吃住行一條龍服務,可是條件有限,請多包涵,有不到之處還請多加指教。現在讓我敬各位一杯,表示歡迎,請賞光,乾杯!</s>	joy	joy
<s></s></s> 走,咱們也走吧。</s>	joy	joy
<s> 走,咱們也走吧。 </s></s> 合適嗎?</s>	joy	fear
<s></s></s> 韓東都走了,咱們在這幹啥?</s>	surprise	surprise
<s> 韓東都走了,咱們在這幹啥? </s></s> 咱們上哪兒?</s>	surprise	surprise
<s></s></s> 上我家去吧,正好跟我媽說說。</s>	joy	joy
<s> 上我家去吧,正好跟我媽說說。 </s></s> 好,走吧。</s>	joy	joy
<s></s></s> 兩位老人這就要走嗎?</s>	surprise	surprise
<s> 兩位老人這就要走嗎? </s></s> 他們從來不在外面吃飯,可能不適應這個環境。</s>	neutral	neutral
<s> 兩位老人這就要走嗎? 他們從來不在外面吃飯,可能不適應這個環境。 </s></s> 先在賓館休息一下吧,我去開個房間。</s>	neutral	joy
<s></s></s> 不用了,他們就是想回家。謝謝王經理。</s>	joy	joy
<s> 不用了,他們就是想回家。謝謝王經理。 </s></s> 也好,那就請自便了。</s>	joy	joy
<s></s></s> 叔叔阿姨怎麼了,沒事吧?</s>	fear	fear
<s> 叔叔阿姨怎麼了,沒事吧? </s></s> 沒事,我先送他們回去。你們不要走吧?</s>	fear	surprise
<s></s></s> 你跟美玉都走了,我們在這幹啥?你們回高麗屯嗎?</s>	surprise	surprise
<s> 你跟美玉都走了,我們在這幹啥?你們回高麗屯嗎? </s></s> 是。</s>	neutral	neutral
<s></s></s> 李鎮長,咱們回去吧。</s>	neutral	neutral
<s> 李鎮長,咱們回去吧。 </s></s> 還回去嗎?不方便吧?他們家裏好像發生了什麼競事。</s>	surprise	surprise
<s> 李鎮長,咱們回去吧。 還回去嗎?不方便吧?他們家裏好像發生了什麼競事。 </s></s> 不進去打個招呼嗎?</s>	surprise	surprise
<s> 李鎮長,咱們回去吧。 還回去嗎?不方便吧?他們家裏好像發生了什麼競事。 不進去打個招呼嗎? </s></s> 回頭你跟他們解釋一下吧。</s>	neutral	neutral
<s> 李鎮長,咱們回去吧。 還回去嗎?不方便吧?他們家裏好像發生了什麼競事。 不進去打個招呼嗎? 回頭你跟他們解釋一下吧。 </s></s> 也行,到我這裏來坐坐吧。</s>	neutral	joy
<s> 李鎮長,咱們回去吧。 還回去嗎?不方便吧?他們家裏好像發生了什麼競事。 不進去打個招呼嗎? 回頭你跟他們解釋一下吧。 也行,到我這裏來坐坐吧。 </s></s> 好。</s>	neutral	joy
<s></s></s> 媽媽,您怎麼了,哪兒不舒服嗎?</s>	fear	fear
<s> 媽媽,您怎麼了,哪兒不舒服嗎? </s></s> 那個人是誰?</s>	surprise	surprise
<s> 媽媽,您怎麼了,哪兒不舒服嗎? 那個人是誰? </s></s> 哪個人?</s>	surprise	surprise
<s> 媽媽,您怎麼了,哪兒不舒服嗎? 那個人是誰? 哪個人? </s></s> 就是最後進來的那一個?</s>	surprise	surprise
<s> 媽媽,您怎麼了,哪兒不舒服嗎? 那個人是誰? 哪個人? 就是最後進來的那一個? </s></s> 那是馬軍他爸。</s>	neutral	neutral
<s> 媽媽,您怎麼了,哪兒不舒服嗎? 那個人是誰? 哪個人? 就是最後進來的那一個? 那是馬軍他爸。 </s></s> 馬軍是誰?</s>	surprise	surprise
<s> 媽媽,您怎麼了,哪兒不舒服嗎? 那個人是誰? 哪個人? 就是最後進來的那一個? 那是馬軍他爸。 馬軍是誰? </s></s> 馬軍就是在他來之前,和女孩一塊進來的那個,是我的好朋友,我們從小就在一塊玩。我不是叫他們了嗎?我是叫給您看的。</s>	neutral	joy
<s> 媽媽,您怎麼了,哪兒不舒服嗎? 那個人是誰? 哪個人? 就是最後進來的那一個? 那是馬軍他爸。 馬軍是誰? 馬軍就是在他來之前,和女孩一塊進來的那個,是我的好朋友,我們從小就在一塊玩。我不是叫他們了嗎?我是叫給您看的。 </s></s> 那孩子和你長的一模一樣,就是沒讓我好好看看他。</s>	sadness	sadness
<s> 媽媽,您怎麼了,哪兒不舒服嗎? 那個人是誰? 哪個人? 就是最後進來的那一個? 那是馬軍他爸。 馬軍是誰? 馬軍就是在他來之前,和女孩一塊進來的那個,是我的好朋友,我們從小就在一塊玩。我不是叫他們了嗎?我是叫給您看的。 那孩子和你長的一模一樣,就是沒讓我好好看看他。 </s></s> 以後有的是機會看他。</s>	joy	joy
<s> 媽媽,您怎麼了,哪兒不舒服嗎? 那個人是誰? 哪個人? 就是最後進來的那一個? 那是馬軍他爸。 馬軍是誰? 馬軍就是在他來之前,和女孩一塊進來的那個,是我的好朋友,我們從小就在一塊玩。我不是叫他們了嗎?我是叫給您看的。 那孩子和你長的一模一樣,就是沒讓我好好看看他。 以後有的是機會看他。 </s></s> 最後進來的那個人是他爸?</s>	surprise	surprise
<s> 媽媽,您怎麼了,哪兒不舒服嗎? 那個人是誰? 哪個人? 就是最後進來的那一個? 那是馬軍他爸。 馬軍是誰? 馬軍就是在他來之前,和女孩一塊進來的那個,是我的好朋友,我們從小就在一塊玩。我不是叫他們了嗎?我是叫給您看的。 那孩子和你長的一模一樣,就是沒讓我好好看看他。 以後有的是機會看他。 最後進來的那個人是他爸? </s></s> 是呀,就是他。</s>	joy	neutral
<s> 那個人是誰? 哪個人? 就是最後進來的那一個? 那是馬軍他爸。 馬軍是誰? 馬軍就是在他來之前,和女孩一塊進來的那個,是我的好朋友,我們從小就在一塊玩。我不是叫他們了嗎?我是叫給您看的。 那孩子和你長的一模一樣,就是沒讓我好好看看他。 以後有的是機會看他。 最後進來的那個人是他爸? 是呀,就是他。 </s></s> 怎麼會是他?他是誰?他是幹什麼的?是個大官嗎?</s>	surprise	surprise
<s> 哪個人? 就是最後進來的那一個? 那是馬軍他爸。 馬軍是誰? 馬軍就是在他來之前,和女孩一塊進來的那個,是我的好朋友,我們從小就在一塊玩。我不是叫他們了嗎?我是叫給您看的。 那孩子和你長的一模一樣,就是沒讓我好好看看他。 以後有的是機會看他。 最後進來的那個人是他爸? 是呀,就是他。 怎麼會是他?他是誰?他是幹什麼的?是個大官嗎? </s></s> 不是大官,是林業局的幹部。怎麼了媽?</s>	surprise	surprise
<s> 就是最後進來的那一個? 那是馬軍他爸。 馬軍是誰? 馬軍就是在他來之前,和女孩一塊進來的那個,是我的好朋友,我們從小就在一塊玩。我不是叫他們了嗎?我是叫給您看的。 那孩子和你長的一模一樣,就是沒讓我好好看看他。 以後有的是機會看他。 最後進來的那個人是他爸? 是呀,就是他。 怎麼會是他?他是誰?他是幹什麼的?是個大官嗎? 不是大官,是林業局的幹部。怎麼了媽? </s></s> 媽媽,您認識他嗎?他怎麼了?</s>	surprise	surprise
<s> 那是馬軍他爸。 馬軍是誰? 馬軍就是在他來之前,和女孩一塊進來的那個,是我的好朋友,我們從小就在一塊玩。我不是叫他們了嗎?我是叫給您看的。 那孩子和你長的一模一樣,就是沒讓我好好看看他。 以後有的是機會看他。 最後進來的那個人是他爸? 是呀,就是他。 怎麼會是他?他是誰?他是幹什麼的?是個大官嗎? 不是大官,是林業局的幹部。怎麼了媽? 媽媽,您認識他嗎?他怎麼了? </s></s> 我不認識他。可是我見過他。我忘不了他!</s>	sadness	surprise
<s></s></s> 就是他,帶着人來咱們家,把我和你爸押到那個大戲臺上,狠毒地打我們。你爸的肋骨給踢斷了兩根,腰也打傷了。從那個時候起,你爸的腰就直不起來了。</s>	sadness	angry
<s> 就是他,帶着人來咱們家,把我和你爸押到那個大戲臺上,狠毒地打我們。你爸的肋骨給踢斷了兩根,腰也打傷了。從那個時候起,你爸的腰就直不起來了。 </s></s> 怎麼是他?馬軍的爸爸?媽媽您沒記錯吧?</s>	surprise	surprise
<s> 就是他,帶着人來咱們家,把我和你爸押到那個大戲臺上,狠毒地打我們。你爸的肋骨給踢斷了兩根,腰也打傷了。從那個時候起,你爸的腰就直不起來了。 怎麼是他?馬軍的爸爸?媽媽您沒記錯吧? </s></s> 我怎麼能記錯!我長這麼大還沒見過像他那麼兇的人!</s>	angry	angry
<s> 就是他,帶着人來咱們家,把我和你爸押到那個大戲臺上,狠毒地打我們。你爸的肋骨給踢斷了兩根,腰也打傷了。從那個時候起,你爸的腰就直不起來了。 怎麼是他?馬軍的爸爸?媽媽您沒記錯吧? 我怎麼能記錯!我長這麼大還沒見過像他那麼兇的人! </s></s> 就是他!就是他帶人抓的我們。我忘不了他!</s>	sadness	angry
<s> 就是他,帶着人來咱們家,把我和你爸押到那個大戲臺上,狠毒地打我們。你爸的肋骨給踢斷了兩根,腰也打傷了。從那個時候起,你爸的腰就直不起來了。 怎麼是他?馬軍的爸爸?媽媽您沒記錯吧? 我怎麼能記錯!我長這麼大還沒見過像他那麼兇的人! 就是他!就是他帶人抓的我們。我忘不了他! </s></s> 怎麼會是這樣的?他們爲什麼要這樣幹?他們這樣胡作非爲就沒人管嗎?</s>	angry	angry
<s> 就是他,帶着人來咱們家,把我和你爸押到那個大戲臺上,狠毒地打我們。你爸的肋骨給踢斷了兩根,腰也打傷了。從那個時候起,你爸的腰就直不起來了。 怎麼是他?馬軍的爸爸?媽媽您沒記錯吧? 我怎麼能記錯!我長這麼大還沒見過像他那麼兇的人! 就是他!就是他帶人抓的我們。我忘不了他! 怎麼會是這樣的?他們爲什麼要這樣幹?他們這樣胡作非爲就沒人管嗎? </s></s> 聽說那是文化大革命。</s>	neutral	sadness
<s> 就是他,帶着人來咱們家,把我和你爸押到那個大戲臺上,狠毒地打我們。你爸的肋骨給踢斷了兩根,腰也打傷了。從那個時候起,你爸的腰就直不起來了。 怎麼是他?馬軍的爸爸?媽媽您沒記錯吧? 我怎麼能記錯!我長這麼大還沒見過像他那麼兇的人! 就是他!就是他帶人抓的我們。我忘不了他! 怎麼會是這樣的?他們爲什麼要這樣幹?他們這樣胡作非爲就沒人管嗎? 聽說那是文化大革命。 </s></s> 我一輩子就是圍着鍋臺轉,大革命跟我有啥關係?我又沒有招惹他們。</s>	angry	angry
<s></s></s> 怎麼下不了手?開大會那天,臺子上押着一排人,都彎着腰,低着頭,脖子上掛着牌子,也都捱了打,就跟剛解放的時候鬥地主一個樣。</s>	joy	angry
<s> 怎麼下不了手?開大會那天,臺子上押着一排人,都彎着腰,低着頭,脖子上掛着牌子,也都捱了打,就跟剛解放的時候鬥地主一個樣。 </s></s> 那個人最壞,他不光是帶人來咱們家抓人,在外面,他只要一碰到我就想打我。我最怕他。</s>	fear	angry
<s> 怎麼下不了手?開大會那天,臺子上押着一排人,都彎着腰,低着頭,脖子上掛着牌子,也都捱了打,就跟剛解放的時候鬥地主一個樣。 那個人最壞,他不光是帶人來咱們家抓人,在外面,他只要一碰到我就想打我。我最怕他。 </s></s> 怎麼會這樣?太可怕了。</s>	fear	fear
<s></s></s> 媽!</s>	surprise	joy
<s> 媽! </s></s> 阿姨!</s>	surprise	joy
<s> 媽! 阿姨! </s></s> 這麼快就回來了,吃完飯了?</s>	surprise	surprise
<s></s></s> 你爺爺呢?他怎麼沒回來?</s>	surprise	surprise
<s> 你爺爺呢?他怎麼沒回來? </s></s> 我們沒吃飯。</s>	sadness	neutral
<s> 你爺爺呢?他怎麼沒回來? 我們沒吃飯。 </s></s> 沒吃飯?那你們幹啥去了?</s>	surprise	surprise
<s></s></s> 我們沒吃成!我爸我爺爺他們在呢。</s>	sadness	neutral
<s> 我們沒吃成!我爸我爺爺他們在呢。 </s></s> 你們沒吃成?怎麼沒吃成?出啥事了嗎?</s>	surprise	surprise
<s></s></s> 開始的時候我爸不在,大夥剛喝了一口酒,我爸進來了。我爸一來就給大夥敬酒。韓東他媽一看見我爸立刻就特別失常,酒杯也掉了,拉着韓東他爸,叫上韓東轉身就走。韓美玉一看這樣,也跟着走了。我一看韓東韓美玉走了,我和白鴿也走了。</s>	neutral	neutral
<s> 開始的時候我爸不在,大夥剛喝了一口酒,我爸進來了。我爸一來就給大夥敬酒。韓東他媽一看見我爸立刻就特別失常,酒杯也掉了,拉着韓東他爸,叫上韓東轉身就走。韓美玉一看這樣,也跟着走了。我一看韓東韓美玉走了,我和白鴿也走了。 </s></s> 你們一走,他那個席還不散了?</s>	surprise	surprise
<s></s></s> 他們大人都在。</s>	neutral	neutral
<s> 他們大人都在。 </s></s> “李鎮長和</s>	neutral	neutral
<s></s></s> 那就剩下我爸跟我爺爺他們三個人了。</s>	sadness	neutral
<s> 那就剩下我爸跟我爺爺他們三個人了。 </s></s> 韓東他媽爲啥失常呀?</s>	sadness	surprise
<s></s></s> 誰知道?</s>	surprise	neutral
<s> 誰知道? </s></s> 她一個家庭婦女,從來沒到過這種場合,一下來了那麼多人還不緊張?</s>	surprise	neutral
<s></s></s> 不對。我爸沒來之前她都沒事,我爸一進來她才失常的。</s>	fear	neutral
<s> 不對。我爸沒來之前她都沒事,我爸一進來她才失常的。 </s></s> 那種場合她就不應該去。我就從來不去。一個家庭婦女上那兒幹啥去?</s>	disgust	disgust
<s></s></s> 反正這裏有問題。</s>	neutral	neutral
<s> 反正這裏有問題。 </s></s> 有啥問題?</s>	surprise	surprise
<s></s></s> 誰知道?等我爸回來問問他就知道了。</s>	fear	neutral
<s> 誰知道?等我爸回來問問他就知道了。 </s></s> 馬軍,我要走了。阿姨,我回去了。</s>	neutral	joy
<s> 誰知道?等我爸回來問問他就知道了。 馬軍,我要走了。阿姨,我回去了。 </s></s> 再玩一會吧?</s>	neutral	surprise
<s></s></s> 不了。</s>	fear	neutral
<s> 不了。 </s></s> 小軍你送她!</s>	surprise	surprise
<s></s></s> 我上她家去玩一會兒。</s>	joy	joy
<s> 我上她家去玩一會兒。 </s></s> 早點回來!</s>	neutral	joy
<s></s></s> 知道。</s>	neutral	joy
<s> 知道。 </s></s> 阿姨再見!</s>	joy	joy
<s></s></s> “這事我兄弟一直也沒跟別人說,連女人自己都不知道。這次我回來他纔跟我說起這件事。他要是永遠不說也就罷了,一說出來反而成了他們的一塊心病,就爲了這個孩子。唉!</s>	sadness	sadness
<s> “這事我兄弟一直也沒跟別人說,連女人自己都不知道。這次我回來他纔跟我說起這件事。他要是永遠不說也就罷了,一說出來反而成了他們的一塊心病,就爲了這個孩子。唉! </s></s> 想不到,你們還扔過一個孩子!</s>	angry	surprise
<s> “這事我兄弟一直也沒跟別人說,連女人自己都不知道。這次我回來他纔跟我說起這件事。他要是永遠不說也就罷了,一說出來反而成了他們的一塊心病,就爲了這個孩子。唉! 想不到,你們還扔過一個孩子! </s></s> 是呀,有了一個孩子本來應該是件好事,結果卻成了這個樣子。</s>	sadness	sadness
<s></s></s> 馬廠長,馬經理,慢走!</s>	surprise	joy
<s> 馬廠長,馬經理,慢走! </s></s> 韓先生請回吧!</s>	joy	joy
<s> 馬廠長,馬經理,慢走! 韓先生請回吧! </s></s> 韓先生請留步!</s>	joy	surprise
<s></s></s> 請問您是韓先生嗎?</s>	neutral	surprise
<s> 請問您是韓先生嗎? </s></s> 我是。你是——</s>	neutral	surprise
<s></s></s> 我是韓東的朋友,我叫陳曉華。您就是韓東的伯父嗎?</s>	neutral	surprise
<s> 我是韓東的朋友,我叫陳曉華。您就是韓東的伯父嗎? </s></s> 我是韓東的伯父。你看見韓東了嗎?</s>	neutral	surprise
<s></s></s> 沒看見,我正要找他呢。我聽說他們一家人都在這裏吃飯,就上這來了。</s>	neutral	surprise
<s> 沒看見,我正要找他呢。我聽說他們一家人都在這裏吃飯,就上這來了。 </s></s> 我們是在這裏吃飯。可是他和他的爸爸媽媽先走了。我也想找他們,不知道他們上哪兒去了?</s>	surprise	surprise
<s></s></s> 如果他們不在這,那肯定是回家了。</s>	neutral	neutral
<s> 如果他們不在這,那肯定是回家了。 </s></s> 他們的家在哪兒?</s>	surprise	surprise
<s></s></s> 在高麗屯。</s>	neutral	neutral
<s> 在高麗屯。 </s></s> 高麗屯?噢,對了,是高麗屯,我去過。姑娘,你知道高麗屯怎麼走嗎?</s>	surprise	surprise
<s></s></s> 知道。</s>	neutral	neutral
<s> 知道。 </s></s> 你能帶我去嗎?</s>	surprise	surprise
<s></s></s> 您要上高麗屯?</s>	surprise	surprise
<s> 您要上高麗屯? </s></s> 是呀,我要去找找他們。</s>	neutral	joy
<s></s></s> 高麗屯挺遠的,要去得顧個車。</s>	neutral	neutral
<s> 高麗屯挺遠的,要去得顧個車。 </s></s> 顧車也行,在哪兒顧呢?</s>	surprise	joy
<s></s></s> 您先在房間裏等等吧,我去顧車,車來了我叫您。</s>	neutral	joy
<s> 您先在房間裏等等吧,我去顧車,車來了我叫您。 </s></s> 好吧,謝謝姑娘!</s>	joy	joy
<s></s></s> 叔叔,咱們走吧。</s>	neutral	joy
<s> 叔叔,咱們走吧。 </s></s> 噢,車來了,走吧。</s>	joy	surprise
<s></s></s> 姑娘,我來付。</s>	neutral	joy
<s> 姑娘,我來付。 </s></s> 我有錢。</s>	joy	joy
<s> 姑娘,我來付。 我有錢。 </s></s> 我知道你有錢,但這錢是應該由我來付的。多少錢?</s>	neutral	surprise
<s></s></s> 爸爸!您怎麼來了?</s>	surprise	surprise
<s> 爸爸!您怎麼來了? </s></s> 我來看看你們,順便接你們回去。</s>	neutral	joy
<s></s></s> 我上賓館找你,碰上韓先生了,正好他要上這來,我就跟他一塊來了。</s>	joy	joy
<s> 我上賓館找你,碰上韓先生了,正好他要上這來,我就跟他一塊來了。 </s></s> 曉華姐!</s>	joy	joy
<s></s></s> 你找我有事嗎?</s>	surprise	surprise
<s> 你找我有事嗎? </s></s> 沒啥事,主要是找馬軍,有個客戶來了,我想讓他快點回青河去。</s>	neutral	neutral
<s></s></s> 怎麼一塊兒都來啦?快進屋吧!</s>	surprise	surprise
<s> 怎麼一塊兒都來啦?快進屋吧! </s></s> 二哥!</s>	joy	joy
<s></s></s> 嗨!今天咱們家大團圓啦!你們看,大爺、爸爸、媽媽、哥哥、嫂子,還有我,不是都來了嗎?</s>	joy	joy
<s> 嗨!今天咱們家大團圓啦!你們看,大爺、爸爸、媽媽、哥哥、嫂子,還有我,不是都來了嗎? </s></s> 別亂說,人家姑娘怎麼是你嫂子呢?</s>	surprise	disgust
<s> 嗨!今天咱們家大團圓啦!你們看,大爺、爸爸、媽媽、哥哥、嫂子,還有我,不是都來了嗎? 別亂說,人家姑娘怎麼是你嫂子呢? </s></s> 她肯定是我嫂子!我來第一眼看見她,我就斷定,這就是我未來的嫂子。曉華姐,你說是不是?</s>	joy	joy
<s> 嗨!今天咱們家大團圓啦!你們看,大爺、爸爸、媽媽、哥哥、嫂子,還有我,不是都來了嗎? 別亂說,人家姑娘怎麼是你嫂子呢? 她肯定是我嫂子!我來第一眼看見她,我就斷定,這就是我未來的嫂子。曉華姐,你說是不是? </s></s> 是不是都讓你說了,我還說啥?</s>	joy	joy
<s> 嗨!今天咱們家大團圓啦!你們看,大爺、爸爸、媽媽、哥哥、嫂子,還有我,不是都來了嗎? 別亂說,人家姑娘怎麼是你嫂子呢? 她肯定是我嫂子!我來第一眼看見她,我就斷定,這就是我未來的嫂子。曉華姐,你說是不是? 是不是都讓你說了,我還說啥? </s></s> 你們看,她承認了吧!</s>	joy	joy
<s> 嗨!今天咱們家大團圓啦!你們看,大爺、爸爸、媽媽、哥哥、嫂子,還有我,不是都來了嗎? 別亂說,人家姑娘怎麼是你嫂子呢? 她肯定是我嫂子!我來第一眼看見她,我就斷定,這就是我未來的嫂子。曉華姐,你說是不是? 是不是都讓你說了,我還說啥? 你們看,她承認了吧! </s></s> 我們東子還有這個福氣嗎?</s>	joy	joy
<s> 嗨!今天咱們家大團圓啦!你們看,大爺、爸爸、媽媽、哥哥、嫂子,還有我,不是都來了嗎? 別亂說,人家姑娘怎麼是你嫂子呢? 她肯定是我嫂子!我來第一眼看見她,我就斷定,這就是我未來的嫂子。曉華姐,你說是不是? 是不是都讓你說了,我還說啥? 你們看,她承認了吧! 我們東子還有這個福氣嗎? </s></s> 有,肯定有!媽媽,這也是您的福氣呀!</s>	joy	joy
<s> 嗨!今天咱們家大團圓啦!你們看,大爺、爸爸、媽媽、哥哥、嫂子,還有我,不是都來了嗎? 別亂說,人家姑娘怎麼是你嫂子呢? 她肯定是我嫂子!我來第一眼看見她,我就斷定,這就是我未來的嫂子。曉華姐,你說是不是? 是不是都讓你說了,我還說啥? 你們看,她承認了吧! 我們東子還有這個福氣嗎? 有,肯定有!媽媽,這也是您的福氣呀! </s></s> 嗯。</s>	joy	joy
<s> 嗨!今天咱們家大團圓啦!你們看,大爺、爸爸、媽媽、哥哥、嫂子,還有我,不是都來了嗎? 別亂說,人家姑娘怎麼是你嫂子呢? 她肯定是我嫂子!我來第一眼看見她,我就斷定,這就是我未來的嫂子。曉華姐,你說是不是? 是不是都讓你說了,我還說啥? 你們看,她承認了吧! 我們東子還有這個福氣嗎? 有,肯定有!媽媽,這也是您的福氣呀! 嗯。 </s></s> 要是我小哥哥也在就好了,那咱們家就更大團圓了。</s>	joy	sadness
<s> 嗨!今天咱們家大團圓啦!你們看,大爺、爸爸、媽媽、哥哥、嫂子,還有我,不是都來了嗎? 別亂說,人家姑娘怎麼是你嫂子呢? 她肯定是我嫂子!我來第一眼看見她,我就斷定,這就是我未來的嫂子。曉華姐,你說是不是? 是不是都讓你說了,我還說啥? 你們看,她承認了吧! 我們東子還有這個福氣嗎? 有,肯定有!媽媽,這也是您的福氣呀! 嗯。 要是我小哥哥也在就好了,那咱們家就更大團圓了。 </s></s> 誰是你小哥哥?</s>	joy	surprise
<s> 嗨!今天咱們家大團圓啦!你們看,大爺、爸爸、媽媽、哥哥、嫂子,還有我,不是都來了嗎? 別亂說,人家姑娘怎麼是你嫂子呢? 她肯定是我嫂子!我來第一眼看見她,我就斷定,這就是我未來的嫂子。曉華姐,你說是不是? 是不是都讓你說了,我還說啥? 你們看,她承認了吧! 我們東子還有這個福氣嗎? 有,肯定有!媽媽,這也是您的福氣呀! 嗯。 要是我小哥哥也在就好了,那咱們家就更大團圓了。 誰是你小哥哥? </s></s> 就是當初媽媽扔掉的那個男孩,那不是我的小哥哥嗎?</s>	joy	surprise
<s> 別亂說,人家姑娘怎麼是你嫂子呢? 她肯定是我嫂子!我來第一眼看見她,我就斷定,這就是我未來的嫂子。曉華姐,你說是不是? 是不是都讓你說了,我還說啥? 你們看,她承認了吧! 我們東子還有這個福氣嗎? 有,肯定有!媽媽,這也是您的福氣呀! 嗯。 要是我小哥哥也在就好了,那咱們家就更大團圓了。 誰是你小哥哥? 就是當初媽媽扔掉的那個男孩,那不是我的小哥哥嗎? </s></s> 上哪兒去找那個孩子呀?</s>	joy	surprise
<s> 她肯定是我嫂子!我來第一眼看見她,我就斷定,這就是我未來的嫂子。曉華姐,你說是不是? 是不是都讓你說了,我還說啥? 你們看,她承認了吧! 我們東子還有這個福氣嗎? 有,肯定有!媽媽,這也是您的福氣呀! 嗯。 要是我小哥哥也在就好了,那咱們家就更大團圓了。 誰是你小哥哥? 就是當初媽媽扔掉的那個男孩,那不是我的小哥哥嗎? 上哪兒去找那個孩子呀? </s></s> 爸爸,您不是說要請那個馬爺爺幫咱們找孩子嗎?跟他說了嗎?</s>	neutral	surprise
<s> 是不是都讓你說了,我還說啥? 你們看,她承認了吧! 我們東子還有這個福氣嗎? 有,肯定有!媽媽,這也是您的福氣呀! 嗯。 要是我小哥哥也在就好了,那咱們家就更大團圓了。 誰是你小哥哥? 就是當初媽媽扔掉的那個男孩,那不是我的小哥哥嗎? 上哪兒去找那個孩子呀? 爸爸,您不是說要請那個馬爺爺幫咱們找孩子嗎?跟他說了嗎? </s></s> 噢,對了,剛纔吃飯的時候,順子突然起身走了,接着你們幾個,還有李鎮長、王經理也走了,就剩下了馬廠長和馬經理我們三個人,弄得我挺難爲情。他們問我怎麼了,是不是家裏有什麼事。我說順子當年扔過一個孩子,這次我回來他們舊事重提,弄得心情很不好。我說了這件事,發現馬廠長和馬經理的表情都有點不大對頭。我當時還有點懊悔,不該跟他們說這件事。</s>	sadness	sadness
<s></s></s> 他們的表情不對頭?難道他們知道這件事?</s>	surprise	surprise
<s> 他們的表情不對頭?難道他們知道這件事? </s></s> 不可能!這件事誰都不知道!</s>	surprise	surprise
<s></s></s> 你扔孩子沒有人知道,可撿孩子的人總知道了吧?</s>	angry	surprise
<s> 你扔孩子沒有人知道,可撿孩子的人總知道了吧? </s></s> 那是他們撿孩子了?</s>	surprise	surprise
<s></s></s> 也可能他們知道撿孩子的人?</s>	surprise	surprise
<s> 也可能他們知道撿孩子的人? </s></s> 爸您當時沒問問他們?</s>	surprise	surprise
<s></s></s> 沒說幾句話他們就走了,我也沒來得及問。</s>	disgust	neutral
<s> 沒說幾句話他們就走了,我也沒來得及問。 </s></s> 沒關係,叫馬軍、白鴿他們問問就行。</s>	joy	joy
<s></s></s> 可千萬別讓他們撿去!</s>	fear	fear
<s> 可千萬別讓他們撿去! </s></s> 誰撿去都行,只要養活了就好。</s>	joy	joy
<s></s></s> 對,不管誰把孩子抱回去,沒讓孩子餓死,從小拉扯大,不容易。咱們都得感謝人家</s>	joy	joy
<s> 對,不管誰把孩子抱回去,沒讓孩子餓死,從小拉扯大,不容易。咱們都得感謝人家 </s></s> 唉!我要是當初不叫長波去扔,那有多好!</s>	joy	sadness
<s></s></s> 後悔了?還不是怪你。</s>	sadness	angry
<s> 後悔了?還不是怪你。 </s></s> 怪我!怪我!那時候你不害怕?</s>	sadness	angry
<s></s></s> 沒關係,媽媽,老馬家的人抱回去更好,反正咱們都是一家人。我的小哥哥,還是回自己的家了。</s>	joy	joy
<s> 沒關係,媽媽,老馬家的人抱回去更好,反正咱們都是一家人。我的小哥哥,還是回自己的家了。 </s></s> 啥?都是一家人?</s>	surprise	surprise
<s></s></s> 你說什麼?誰抱回自己家了?</s>	angry	surprise
<s> 你說什麼?誰抱回自己家了? </s></s> 就是馬軍他們家,和咱們是一家人。</s>	joy	joy
<s></s></s> 咱們和誰是一家人?我怎麼不明白?</s>	surprise	surprise
<s> 咱們和誰是一家人?我怎麼不明白? </s></s> 你們都不知道吧?我也是來了以後才知道。告訴你們吧,馬軍他爸,他也是我曉華姐的爸。</s>	joy	joy
<s></s></s> 你是說,你曉華姐,她是馬總的女兒,馬廠長的孫女?</s>	surprise	surprise
<s> 你是說,你曉華姐,她是馬總的女兒,馬廠長的孫女? </s></s> 對呀!是馬總的親女兒,馬廠長的親孫女。不信您問曉華姐。</s>	neutral	joy
<s></s></s> 姑娘,是這樣嗎?</s>	surprise	surprise
<s> 姑娘,是這樣嗎? </s></s> 是的。</s>	neutral	neutral
<s></s></s> 可是,你不是說你姓陳嗎?</s>	surprise	surprise
<s> 可是,你不是說你姓陳嗎? </s></s> 她是跟她媽一個姓,沒跟她爸。</s>	sadness	neutral
<s></s></s> 我媽生下我不久就死了,是姥姥和小姨把我帶大的。我爸對我媽不好,我姥姥也不喜歡我爸,所以我從來不到我爸他們家裏去,也不姓他們家的姓。</s>	sadness	disgust
<s> 我媽生下我不久就死了,是姥姥和小姨把我帶大的。我爸對我媽不好,我姥姥也不喜歡我爸,所以我從來不到我爸他們家裏去,也不姓他們家的姓。 </s></s> 是這樣。你爸他怎麼對你媽不好呢?</s>	surprise	surprise
<s></s></s> 我也不知道,反正我小姨從來都不理我爸。</s>	sadness	neutral
<s> 我也不知道,反正我小姨從來都不理我爸。 </s></s> 你姥姥還在嗎?</s>	surprise	surprise
<s></s></s> 她早就去世了。</s>	sadness	sadness
<s> 她早就去世了。 </s></s> 從你記事以後,你有沒有感覺到你爸對你和你小姨不好呢?</s>	sadness	surprise
<s></s></s> 那倒沒有。</s>	neutral	neutral
<s> 那倒沒有。 </s></s> 那究竟是爲了什麼事才讓你小姨對你爸有那麼大的成見呢?</s>	surprise	surprise
<s></s></s> 其實她爸對她小姨挺好的。她小姨開飯店的時候還給她了好幾千塊錢呢。她上山下鄉回來以後,也是她爸給安排的工作。</s>	joy	neutral
<s> 其實她爸對她小姨挺好的。她小姨開飯店的時候還給她了好幾千塊錢呢。她上山下鄉回來以後,也是她爸給安排的工作。 </s></s> 是這樣嗎?</s>	surprise	surprise
<s></s></s> 是的。</s>	neutral	neutral
<s> 是的。 </s></s> 一般來說,作老人的沒有不心疼自己孩子的。你小姨可能對你爸有什麼偏見。就算你爸年輕的時候有什麼過錯,但他畢竟是你的生身父親。這個關係是不可改變的。</s>	neutral	joy
<s></s></s> 我也是這樣想。</s>	neutral	joy
<s> 我也是這樣想。 </s></s> 作爲女兒,你有沒有想過、希望你的爸爸來疼你愛你呢?</s>	joy	surprise
<s></s></s> 我當然想過。可是他能疼我愛我嗎?</s>	sadness	sadness
<s> 我當然想過。可是他能疼我愛我嗎? </s></s> 那要看你認不認他了。你要是不認他,他怎麼疼你愛你呀?</s>	sadness	sadness
<s></s></s> 怎麼樣,我沒說錯吧?曉華姐跟我東哥一結婚,咱們跟老馬家不就是親戚了嗎?還不是一家人?</s>	surprise	joy
<s> 怎麼樣,我沒說錯吧?曉華姐跟我東哥一結婚,咱們跟老馬家不就是親戚了嗎?還不是一家人? </s></s> 這姑娘就是會說話。</s>	joy	joy
<s></s></s> 這都是真的。</s>	joy	joy
<s> 這都是真的。 </s></s> 好啊,好啊!都是一家人,一家人啦!今天的飯雖然沒吃好,咱們一家人可是團聚了。我這趟算是沒白來,以後就放心了。</s>	joy	joy
<s></s></s> 可是,我的那個小弟弟還沒找到呢!爸爸,您再去跟馬廠長他們說說吧,請他們幫忙找一找。</s>	fear	sadness
<s> 可是,我的那個小弟弟還沒找到呢!爸爸,您再去跟馬廠長他們說說吧,請他們幫忙找一找。 </s></s> 不用大爺去說了,我去和馬軍、白鴿說一說就行。他們家的人都是林業局的,讓他們幫忙打聽打聽。</s>	neutral	joy
<s></s></s> 這樣也好,咱們家的事儘量不要驚動太多的人。美玉,天不早了,咱們早點回去吧,讓他們也早點休息。</s>	joy	surprise
<s> 這樣也好,咱們家的事儘量不要驚動太多的人。美玉,天不早了,咱們早點回去吧,讓他們也早點休息。 </s></s> 怎麼,這就要走了?</s>	surprise	surprise
<s></s></s> 是呀,準備一下,我們也該往回走了。</s>	neutral	neutral
<s> 是呀,準備一下,我們也該往回走了。 </s></s> 回哪兒?回南朝鮮?</s>	surprise	surprise
<s></s></s> 是呀,回南朝鮮。</s>	joy	neutral
<s> 是呀,回南朝鮮。 </s></s> 再住幾天吧!</s>	joy	surprise
<s></s></s> 不行,美玉該上學了。</s>	joy	disgust
<s> 不行,美玉該上學了。 </s></s> 是,我們學校快開學了。</s>	joy	neutral
<s></s></s> 哪天走?我去送你們。</s>	joy	surprise
<s> 哪天走?我去送你們。 </s></s> 買好了票我告訴你們。</s>	neutral	joy
<s></s></s> 東子,什麼時候再來能把你弟弟帶來就好了。</s>	joy	sadness
<s> 東子,什麼時候再來能把你弟弟帶來就好了。 </s></s> 能,一定能,你不用着急。</s>	joy	joy
<s></s></s> 還有這個姑娘,叫啥名兒來?</s>	surprise	surprise
<s> 還有這個姑娘,叫啥名兒來? </s></s> 阿姨,我叫曉華。</s>	joy	joy
<s></s></s> 對,曉華,你有幾年沒來了,以後常來吧。</s>	joy	joy
<s> 對,曉華,你有幾年沒來了,以後常來吧。 </s></s> 我會的,阿姨。</s>	joy	joy
<s></s></s> 好,走吧。</s>	joy	joy
<s> 好,走吧。 </s></s> 媽媽、二叔,再見!</s>	joy	joy
<s></s></s> 怎麼了,都跟霜打了似的?</s>	fear	surprise
<s> 怎麼了,都跟霜打了似的? </s></s> 你們不是赴宴去了嗎?小軍和白鴿也去了?可他倆說飯也沒吃成,你倆也沒吃痛快?</s>	surprise	surprise
<s> 怎麼了,都跟霜打了似的? 你們不是赴宴去了嗎?小軍和白鴿也去了?可他倆說飯也沒吃成,你倆也沒吃痛快? </s></s> 咋的了?出啥事了嗎?</s>	surprise	surprise
<s> 怎麼了,都跟霜打了似的? 你們不是赴宴去了嗎?小軍和白鴿也去了?可他倆說飯也沒吃成,你倆也沒吃痛快? 咋的了?出啥事了嗎? </s></s> 誰來了?</s>	surprise	surprise
<s> 怎麼了,都跟霜打了似的? 你們不是赴宴去了嗎?小軍和白鴿也去了?可他倆說飯也沒吃成,你倆也沒吃痛快? 咋的了?出啥事了嗎? 誰來了? </s></s> 那個孩子的主人露頭了。</s>	neutral	fear
<s></s></s> 哪個孩子?</s>	neutral	surprise
<s> 哪個孩子? </s></s> 就是你從醫院抱回來的那個孩子。</s>	neutral	surprise
<s></s></s> 我從醫院抱回來的那個孩子?</s>	surprise	surprise
<s> 我從醫院抱回來的那個孩子? </s></s> 是啊。</s>	neutral	sadness
<s></s></s> 這都多少年了?那個人還在嗎?</s>	surprise	surprise
<s> 這都多少年了?那個人還在嗎? </s></s> 怎麼不在?</s>	surprise	disgust
<s></s></s> 那是誰呀?</s>	surprise	surprise
<s> 那是誰呀? </s></s> 韓長脖。</s>	neutral	neutral
<s></s></s> 韓長脖?怎麼是他?</s>	surprise	surprise
<s> 韓長脖?怎麼是他? </s></s> 怎麼不是他?</s>	surprise	surprise
<s></s></s> 他啥時候生了孩子又扔在醫院呢?</s>	angry	surprise
<s> 他啥時候生了孩子又扔在醫院呢? </s></s> “可不是嗎!你忘了?那一年,一九六八年,老爸住院</s>	surprise	surprise
<s></s></s> 我還沒顧上看是男孩還是女孩!</s>	angry	surprise
<s> 我還沒顧上看是男孩還是女孩! </s></s> 也好,給他們,由他們處理會好一些,一上班你就送過去。</s>	joy	joy
<s></s></s> 不行。人家說不定啥時候開大會,一開大會就來叫,叫了就得去,還是在這方便。</s>	joy	disgust
<s> 不行。人家說不定啥時候開大會,一開大會就來叫,叫了就得去,還是在這方便。 </s></s> 咋的了?</s>	surprise	surprise
<s> 不行。人家說不定啥時候開大會,一開大會就來叫,叫了就得去,還是在這方便。 咋的了? </s></s> 我們不能收。</s>	fear	fear
<s></s></s> 爸,求你個事兒。</s>	sadness	fear
<s> 爸,求你個事兒。 </s></s> 什麼事兒,還要求我?</s>	surprise	surprise
<s></s></s> 求你幫忙給查一下檔案。</s>	fear	fear
<s> 求你幫忙給查一下檔案。 </s></s> 什麼檔案?</s>	surprise	surprise
<s></s></s> 住院檔案。</s>	neutral	neutral
<s> 住院檔案。 </s></s> 什麼住院檔案?</s>	surprise	surprise
<s></s></s> 一九六八年,大概五、六月份吧,反正天暖和的時候,都有什麼人在咱們醫院住院?</s>	surprise	surprise
<s> 一九六八年,大概五、六月份吧,反正天暖和的時候,都有什麼人在咱們醫院住院? </s></s> 扔在哪兒了?</s>	surprise	surprise
<s></s></s> 扔在醫院走廊的長椅子上了。</s>	neutral	neutral
<s> 扔在醫院走廊的長椅子上了。 </s></s> 扔在那又怎麼樣?</s>	fear	surprise
<s></s></s> 被當時住院的一個人抱走了。</s>	sadness	neutral
<s> 被當時住院的一個人抱走了。 </s></s> 抱走了又怎麼樣?</s>	fear	surprise
<s></s></s> 他們現在要找回這個孩子。</s>	neutral	neutral
<s> 他們現在要找回這個孩子。 </s></s> 誰要找回這個孩子?</s>	surprise	surprise
<s></s></s> 就是扔孩子的那個人。</s>	neutral	neutral
<s> 就是扔孩子的那個人。 </s></s> 哦,看來事情是挺湊巧呀。</s>	joy	joy
<s></s></s> 那您也知道那個孩子是誰了?</s>	angry	surprise
<s> 那您也知道那個孩子是誰了? </s></s> 當然知道。</s>	neutral	joy
<s></s></s> 那是誰呀?</s>	surprise	surprise
<s> 那是誰呀? </s></s> “抱孩子的是馬</s>	neutral	neutral
<s></s></s> 高秀英?不認識。</s>	surprise	surprise
<s> 高秀英?不認識。 </s></s> 就是馬軍他媽。</s>	joy	neutral
<s></s></s> 馬軍他媽?那她抱回去的孩子是誰呀?</s>	surprise	surprise
<s> 馬軍他媽?那她抱回去的孩子是誰呀? </s></s> “</s>	neutral	neutral
<s></s></s> 怎麼不是馬軍?她就那一個孩子嘛。</s>	surprise	neutral
<s> 怎麼不是馬軍?她就那一個孩子嘛。 </s></s> 這麼說馬軍是她從醫院抱回來的了?</s>	surprise	surprise
<s> 怎麼不是馬軍?她就那一個孩子嘛。 這麼說馬軍是她從醫院抱回來的了? </s></s> 那可不唄。</s>	joy	neutral
<s></s></s> 那馬軍就是韓東他爸扔在醫院長椅子上的孩子?</s>	surprise	surprise
<s> 那馬軍就是韓東他爸扔在醫院長椅子上的孩子? </s></s> 孩子是在醫院的長椅子上,是誰扔的可不知道。</s>	neutral	neutral
<s></s></s> “怎麼是這樣的呢?</s>	surprise	surprise
<s> “怎麼是這樣的呢? </s></s> 還沒有我?那是啥時候呀?</s>	surprise	surprise
<s> “怎麼是這樣的呢? 還沒有我?那是啥時候呀? </s></s> 你不說是一九六八年嗎?你在哪兒呢?</s>	surprise	neutral
<s></s></s> 一九六八年?就是你們說的文化大革命那時候?</s>	surprise	surprise
<s> 一九六八年?就是你們說的文化大革命那時候? </s></s> 對呀。</s>	joy	neutral
<s></s></s> 哎呀,真是太離奇了!</s>	surprise	surprise
<s> 哎呀,真是太離奇了! </s></s> “我跟你說,這件事本來不是祕密。人家把孩子抱回去是爲了救那個孩子,並不是揹着人偷偷摸摸抱走的。孩子他們家的人來要,他們隨時都準備還給他們。可是這麼多年也沒人問沒人要。現在孩子長大了,他再來要孩子,可就不那麼簡單了。第一,誰能證明醫院長椅子上的孩子是你扔下的?你生下的孩子爲啥扔在醫院的椅子上?第二,事情過去了二十多年,你爲啥一直不吭氣?第三,現在孩子長大成人了,你來要了,怎麼證明那是你的孩子?就算真是你的孩子,你還有資格往回要嗎?人家願意給你嗎?孩子本人願意回去嗎?</s>	angry	sadness
<s></s></s> 看來,問題還不簡單呢。</s>	neutral	fear
<s> 看來,問題還不簡單呢。 </s></s> “那當然了。處理這件事可不能冒冒失失的。那孩子</s>	neutral	sadness
<s></s></s> 馬軍!馬軍!</s>	joy	surprise
<s> 馬軍!馬軍! </s></s> 誰呀?小白鴿呀!快進屋吧。</s>	joy	joy
<s></s></s> 我不進去了阿姨,我找馬軍。</s>	neutral	neutral
<s> 我不進去了阿姨,我找馬軍。 </s></s> 咳,小軍他還沒起牀呢。你進來吧。</s>	neutral	joy
<s></s></s> 不了阿姨,我找馬軍有急事兒,您叫他快點出來吧。</s>	neutral	surprise
<s> 不了阿姨,我找馬軍有急事兒,您叫他快點出來吧。 </s></s> 好,我這就去叫他。</s>	neutral	neutral
<s></s></s> 啥事兒這麼急,有客戶了來了?</s>	surprise	surprise
<s> 啥事兒這麼急,有客戶了來了? </s></s> 沒有客戶,走吧,到那就知道了。</s>	neutral	surprise
<s> 啥事兒這麼急,有客戶了來了? 沒有客戶,走吧,到那就知道了。 </s></s> 到哪兒?</s>	surprise	surprise
<s> 啥事兒這麼急,有客戶了來了? 沒有客戶,走吧,到那就知道了。 到哪兒? </s></s> 韓東那兒。</s>	neutral	surprise
<s> 啥事兒這麼急,有客戶了來了? 沒有客戶,走吧,到那就知道了。 到哪兒? 韓東那兒。 </s></s> 韓東那兒?啥事這麼急?</s>	surprise	surprise
<s> 啥事兒這麼急,有客戶了來了? 沒有客戶,走吧,到那就知道了。 到哪兒? 韓東那兒。 韓東那兒?啥事這麼急? </s></s> 走吧,去了就知道。</s>	joy	surprise
<s></s></s> 我說韓東,你怎麼還住在這?你都不在勞動服務公司幹了,怎麼還住人家的房子呀?</s>	angry	surprise
<s> 我說韓東,你怎麼還住在這?你都不在勞動服務公司幹了,怎麼還住人家的房子呀? </s></s> 不住這我住哪兒?再說,他們也願意讓我在這住,晚上還可以幫他們看庫房呢。</s>	joy	joy
<s> 我說韓東,你怎麼還住在這?你都不在勞動服務公司幹了,怎麼還住人家的房子呀? 不住這我住哪兒?再說,他們也願意讓我在這住,晚上還可以幫他們看庫房呢。 </s></s> 你給他們交房租嗎?</s>	surprise	surprise
<s> 我說韓東,你怎麼還住在這?你都不在勞動服務公司幹了,怎麼還住人家的房子呀? 不住這我住哪兒?再說,他們也願意讓我在這住,晚上還可以幫他們看庫房呢。 你給他們交房租嗎? </s></s> 我不跟他們要工錢就不錯了,還給他房租?</s>	surprise	disgust
<s> 我說韓東,你怎麼還住在這?你都不在勞動服務公司幹了,怎麼還住人家的房子呀? 不住這我住哪兒?再說,他們也願意讓我在這住,晚上還可以幫他們看庫房呢。 你給他們交房租嗎? 我不跟他們要工錢就不錯了,還給他房租? </s></s> 別說閒話了,咱們言歸正傳。馬軍,咱們昨天商量的事你跟你爸說了嗎?</s>	neutral	surprise
<s></s></s> 是這樣的?</s>	surprise	surprise
<s> 是這樣的? </s></s> 那個孩子是馬軍?</s>	surprise	surprise
<s></s></s> 看來事情是清楚了。老人們根本沒把這當回事,在當時這根本不是什麼祕密。</s>	neutral	neutral
<s> 看來事情是清楚了。老人們根本沒把這當回事,在當時這根本不是什麼祕密。 </s></s> 他們根本就不知道扔孩子的人就在跟前。</s>	angry	neutral
<s></s></s> 媽!</s>	surprise	surprise
<s> 媽! </s></s> 阿姨!</s>	surprise	surprise
<s> 媽! 阿姨! </s></s> 今天你倆都沒上青河去?</s>	surprise	surprise
<s></s></s> 有事兒,下午再去。</s>	neutral	fear
<s> 有事兒,下午再去。 </s></s> 離了公司你們還能有啥事兒?</s>	surprise	surprise
<s></s></s> 媽,那天我問你們的那個事,看來是真的了?</s>	surprise	surprise
<s> 媽,那天我問你們的那個事,看來是真的了? </s></s> 啥事兒?</s>	surprise	surprise
<s></s></s> 撿孩子的事兒。</s>	neutral	neutral
<s> 撿孩子的事兒。 </s></s> 你又聽到啥消息了?</s>	surprise	fear
<s></s></s> 聽到可靠消息了。</s>	neutral	neutral
<s> 聽到可靠消息了。 </s></s> 啥可靠消息?</s>	surprise	fear
<s></s></s> 白鴿她爸說,您就是從醫院撿回了一個孩子。</s>	neutral	neutral
<s> 白鴿她爸說,您就是從醫院撿回了一個孩子。 </s></s> 是嗎?</s>	surprise	fear
<s></s></s> 是的。我爸說,這件事當時全林業局的人都知道。</s>	neutral	neutral
<s> 是的。我爸說,這件事當時全林業局的人都知道。 </s></s> 沒錯,當時大家都知道,這不奇怪。我又不是偷的,是公開抱回來的。</s>	neutral	fear
<s></s></s> 那您咋不告訴我?</s>	surprise	surprise
<s> 那您咋不告訴我? </s></s> 我怎麼告訴你?你還在我懷裏吃奶呢!</s>	angry	angry
<s></s></s> 那現在呢?現在人家要來找孩子了。</s>	surprise	surprise
<s> 那現在呢?現在人家要來找孩子了。 </s></s> 誰來找孩子?</s>	surprise	surprise
<s></s></s> 就是扔孩子的人唄!</s>	neutral	surprise
<s> 就是扔孩子的人唄! </s></s> 找去唄,扔哪兒了上哪兒找去!</s>	joy	disgust
<s></s></s> 他扔在醫院走廊的長椅子上了。您正好是從醫院的長椅子上抱回來的,可不就找您唄。</s>	joy	sadness
<s> 他扔在醫院走廊的長椅子上了。您正好是從醫院的長椅子上抱回來的,可不就找您唄。 </s></s> “</s>	neutral	angry
<s></s></s> 您的意思是說他們訛您?</s>	surprise	surprise
<s> 您的意思是說他們訛您? </s></s> 我看有點像,要不爲啥這麼多年不吭氣,現在突然想起來找孩子了呢?</s>	surprise	angry
<s></s></s> “阿姨,那倒不是。他們</s>	fear	fear
<s> “阿姨,那倒不是。他們 </s></s> 阿姨,您別急,這事不怪您。是他們一直沒說,沒吭氣兒。</s>	fear	surprise
<s> “阿姨,那倒不是。他們 阿姨,您別急,這事不怪您。是他們一直沒說,沒吭氣兒。 </s></s> 這都二十多年了,我還一直等他們來找呢,又不是外地的,這不都在景陽鎮嗎?不還都是熟人嗎?咋就不吭個氣兒呢?</s>	disgust	angry
<s></s></s> 阿姨,我們也是現在才知道,這事誰也不怪,就怪韓東他爸。當初孩子生下來,韓東他媽不想要,讓他爸扔掉。可是他爸沒扔,擱在醫院的椅子上了,他又不跟他媽說,他媽一直以爲孩子已經沒了。您說,除了他自己,誰還能知道?</s>	sadness	disgust
<s> 阿姨,我們也是現在才知道,這事誰也不怪,就怪韓東他爸。當初孩子生下來,韓東他媽不想要,讓他爸扔掉。可是他爸沒扔,擱在醫院的椅子上了,他又不跟他媽說,他媽一直以爲孩子已經沒了。您說,除了他自己,誰還能知道? </s></s> 那小軍怎麼還埋怨我?</s>	sadness	sadness
<s></s></s> 不是我埋怨您,我就是不明白。</s>	sadness	sadness
<s> 不是我埋怨您,我就是不明白。 </s></s> 我還不明白呢!他怎麼現在又說了?又想找了,想要了?</s>	surprise	angry
<s></s></s> 韓東他大爺來了,他爸跟他大爺說起了這件事,他媽一聽說孩子還在,她能不找嗎?我看他爸那人也是,悶聲悶氣,傻里傻氣的缺心眼兒,要不咋都叫他韓長脖呢。</s>	neutral	angry
<s> 韓東他大爺來了,他爸跟他大爺說起了這件事,他媽一聽說孩子還在,她能不找嗎?我看他爸那人也是,悶聲悶氣,傻里傻氣的缺心眼兒,要不咋都叫他韓長脖呢。 </s></s> 您要不抱,就給別人抱走了。</s>	neutral	sadness
<s> 韓東他大爺來了,他爸跟他大爺說起了這件事,他媽一聽說孩子還在,她能不找嗎?我看他爸那人也是,悶聲悶氣,傻里傻氣的缺心眼兒,要不咋都叫他韓長脖呢。 您要不抱,就給別人抱走了。 </s></s> 別人?我是上醫院伺候你爺爺起牀,去得早。要是等到醫院上班有人來的時候,孩子早死了!</s>	surprise	angry
<s></s></s> 爸爸,媽媽扔的那個孩子找到了。</s>	neutral	joy
<s> 爸爸,媽媽扔的那個孩子找到了。 </s></s> 啊,這麼快就找到了?誰給找到的?</s>	surprise	surprise
<s> 爸爸,媽媽扔的那個孩子找到了。 啊,這麼快就找到了?誰給找到的? </s></s> 小白鴿回家問她爸了,他爸說的。</s>	neutral	neutral
<s> 爸爸,媽媽扔的那個孩子找到了。 啊,這麼快就找到了?誰給找到的? 小白鴿回家問她爸了,他爸說的。 </s></s> 他爸是誰?</s>	surprise	surprise
<s> 爸爸,媽媽扔的那個孩子找到了。 啊,這麼快就找到了?誰給找到的? 小白鴿回家問她爸了,他爸說的。 他爸是誰? </s></s> “他爸是林業局的幹部。他爸說,這事在當時不是什麼祕密,</s>	neutral	neutral
<s></s></s> 那個孩子到底是誰?你們認識嗎?</s>	surprise	surprise
<s> 那個孩子到底是誰?你們認識嗎? </s></s> 太認識了!</s>	joy	joy
<s> 那個孩子到底是誰?你們認識嗎? 太認識了! </s></s> 那是誰呀?</s>	surprise	surprise
<s> 那個孩子到底是誰?你們認識嗎? 太認識了! 那是誰呀? </s></s> 就是馬軍!</s>	joy	joy
<s> 那個孩子到底是誰?你們認識嗎? 太認識了! 那是誰呀? 就是馬軍! </s></s> 馬軍?</s>	surprise	surprise
<s> 那個孩子到底是誰?你們認識嗎? 太認識了! 那是誰呀? 就是馬軍! 馬軍? </s></s> 就是馬廠長的孫子、馬經理的兒子馬軍!</s>	joy	joy
<s> 那個孩子到底是誰?你們認識嗎? 太認識了! 那是誰呀? 就是馬軍! 馬軍? 就是馬廠長的孫子、馬經理的兒子馬軍! </s></s> 馬軍?</s>	surprise	surprise
<s> 那個孩子到底是誰?你們認識嗎? 太認識了! 那是誰呀? 就是馬軍! 馬軍? 就是馬廠長的孫子、馬經理的兒子馬軍! 馬軍? </s></s> “就是在賓館吃飯的時候最後進來的那兩個孩子,韓東叫了他們一聲:馬軍、白鴿!</s>	joy	joy
<s></s></s> 噢,就是你說的小白鴿的男朋友?</s>	surprise	surprise
<s> 噢,就是你說的小白鴿的男朋友? </s></s> 對呀!</s>	joy	joy
<s> 噢,就是你說的小白鴿的男朋友? 對呀! </s></s> “</s>	neutral	surprise
<s></s></s> 怎麼會搞錯呢?他們還是韓東的朋友。</s>	surprise	surprise
<s> 怎麼會搞錯呢?他們還是韓東的朋友。 </s></s> 是韓東的朋友?</s>	surprise	surprise
<s> 怎麼會搞錯呢?他們還是韓東的朋友。 是韓東的朋友? </s></s> 是,他們早就是朋友。</s>	joy	neutral
<s> 怎麼會搞錯呢?他們還是韓東的朋友。 是韓東的朋友? 是,他們早就是朋友。 </s></s> 這事你叔叔他們知道嗎?</s>	surprise	surprise
<s> 怎麼會搞錯呢?他們還是韓東的朋友。 是韓東的朋友? 是,他們早就是朋友。 這事你叔叔他們知道嗎? </s></s> 韓東知道了,他們可能也就知道了。</s>	neutral	neutral
<s> 怎麼會搞錯呢?他們還是韓東的朋友。 是韓東的朋友? 是,他們早就是朋友。 這事你叔叔他們知道嗎? 韓東知道了,他們可能也就知道了。 </s></s> 馬軍家裏也知道了吧?</s>	neutral	surprise
<s> 怎麼會搞錯呢?他們還是韓東的朋友。 是韓東的朋友? 是,他們早就是朋友。 這事你叔叔他們知道嗎? 韓東知道了,他們可能也就知道了。 馬軍家裏也知道了吧? </s></s> 肯定也知道了唄。</s>	joy	joy
<s> 怎麼會搞錯呢?他們還是韓東的朋友。 是韓東的朋友? 是,他們早就是朋友。 這事你叔叔他們知道嗎? 韓東知道了,他們可能也就知道了。 馬軍家裏也知道了吧? 肯定也知道了唄。 </s></s> 我想起來了,那天吃飯的時候我說起順子扔孩子的事,馬廠長他們爺倆表情有點反常,看來是有原因的。</s>	neutral	neutral
<s> 怎麼會搞錯呢?他們還是韓東的朋友。 是韓東的朋友? 是,他們早就是朋友。 這事你叔叔他們知道嗎? 韓東知道了,他們可能也就知道了。 馬軍家裏也知道了吧? 肯定也知道了唄。 我想起來了,那天吃飯的時候我說起順子扔孩子的事,馬廠長他們爺倆表情有點反常,看來是有原因的。 </s></s> 那原因正在於此吧。</s>	neutral	neutral
<s> 怎麼會搞錯呢?他們還是韓東的朋友。 是韓東的朋友? 是,他們早就是朋友。 這事你叔叔他們知道嗎? 韓東知道了,他們可能也就知道了。 馬軍家裏也知道了吧? 肯定也知道了唄。 我想起來了,那天吃飯的時候我說起順子扔孩子的事,馬廠長他們爺倆表情有點反常,看來是有原因的。 那原因正在於此吧。 </s></s> 這件事得和順子他們說一說,孩子固然找到了,可現在咱們不能跟人家往回要。人家把孩子養大了不容易。再說,孩子願不願意回來也是個問題。</s>	neutral	sadness
<s> 怎麼會搞錯呢?他們還是韓東的朋友。 是韓東的朋友? 是,他們早就是朋友。 這事你叔叔他們知道嗎? 韓東知道了,他們可能也就知道了。 馬軍家裏也知道了吧? 肯定也知道了唄。 我想起來了,那天吃飯的時候我說起順子扔孩子的事,馬廠長他們爺倆表情有點反常,看來是有原因的。 那原因正在於此吧。 這件事得和順子他們說一說,孩子固然找到了,可現在咱們不能跟人家往回要。人家把孩子養大了不容易。再說,孩子願不願意回來也是個問題。 </s></s> 對,這件事就由馬軍自己決定,由他們兩個家決定。</s>	neutral	neutral
<s> 是韓東的朋友? 是,他們早就是朋友。 這事你叔叔他們知道嗎? 韓東知道了,他們可能也就知道了。 馬軍家裏也知道了吧? 肯定也知道了唄。 我想起來了,那天吃飯的時候我說起順子扔孩子的事,馬廠長他們爺倆表情有點反常,看來是有原因的。 那原因正在於此吧。 這件事得和順子他們說一說,孩子固然找到了,可現在咱們不能跟人家往回要。人家把孩子養大了不容易。再說,孩子願不願意回來也是個問題。 對,這件事就由馬軍自己決定,由他們兩個家決定。 </s></s> 這是一件好事。咱們應該去告訴順子,讓她高興纔是,也順便爲她祝賀一下。</s>	joy	joy
<s> 是,他們早就是朋友。 這事你叔叔他們知道嗎? 韓東知道了,他們可能也就知道了。 馬軍家裏也知道了吧? 肯定也知道了唄。 我想起來了,那天吃飯的時候我說起順子扔孩子的事,馬廠長他們爺倆表情有點反常,看來是有原因的。 那原因正在於此吧。 這件事得和順子他們說一說,孩子固然找到了,可現在咱們不能跟人家往回要。人家把孩子養大了不容易。再說,孩子願不願意回來也是個問題。 對,這件事就由馬軍自己決定,由他們兩個家決定。 這是一件好事。咱們應該去告訴順子,讓她高興纔是,也順便爲她祝賀一下。 </s></s> 對,咱們現在就去!我去把東哥找來一塊去!</s>	joy	joy
<s> 這事你叔叔他們知道嗎? 韓東知道了,他們可能也就知道了。 馬軍家裏也知道了吧? 肯定也知道了唄。 我想起來了,那天吃飯的時候我說起順子扔孩子的事,馬廠長他們爺倆表情有點反常,看來是有原因的。 那原因正在於此吧。 這件事得和順子他們說一說,孩子固然找到了,可現在咱們不能跟人家往回要。人家把孩子養大了不容易。再說,孩子願不願意回來也是個問題。 對,這件事就由馬軍自己決定,由他們兩個家決定。 這是一件好事。咱們應該去告訴順子,讓她高興纔是,也順便爲她祝賀一下。 對,咱們現在就去!我去把東哥找來一塊去! </s></s> 好,你去找韓東,我去買一點東西,咱們這就走!</s>	joy	joy
<s></s></s> 二哥!美玉!</s>	joy	joy
<s> 二哥!美玉! </s></s> 媽媽!三叔!</s>	joy	joy
<s></s></s> 你們怎麼來了?</s>	surprise	surprise
<s> 你們怎麼來了? </s></s> 來看看你們,沒出門吧?</s>	neutral	joy
<s></s></s> 美玉,快把那個好消息告訴你媽媽吧?</s>	joy	joy
<s> 美玉,快把那個好消息告訴你媽媽吧? </s></s> 好消息?還有什麼好消息呀?</s>	surprise	surprise
<s></s></s> 媽媽,是好消息,最大的好消息!</s>	joy	joy
<s> 媽媽,是好消息,最大的好消息! </s></s> 那就說說吧,是個什麼好消息?</s>	joy	joy
<s></s></s> 媽媽,您丟的那個孩子找到了!</s>	surprise	joy
<s> 媽媽,您丟的那個孩子找到了! </s></s> 什麼?你說什麼?</s>	surprise	surprise
<s></s></s> 您丟的那個孩子,找到了!</s>	surprise	joy
<s> 您丟的那個孩子,找到了! </s></s> 我丟的那個孩子?找到了?</s>	surprise	surprise
<s></s></s> 對呀!您丟的那個孩子,他找到了!</s>	surprise	joy
<s> 對呀!您丟的那個孩子,他找到了! </s></s> 找到了?我的孩子他沒死,他還活着?他是誰?他在哪兒?</s>	surprise	surprise
<s></s></s> 他就是馬軍!</s>	angry	joy
<s> 他就是馬軍! </s></s> 馬軍?馬軍是誰?</s>	surprise	surprise
<s></s></s> 馬軍是馬經理的兒子,是馬廠長的孫子。</s>	neutral	joy
<s> 馬軍是馬經理的兒子,是馬廠長的孫子。 </s></s> 馬經理是誰?馬廠長是誰?</s>	surprise	surprise
<s></s></s> 前天在賓館吃飯的時候,不是有兩個孩子最後進來的嗎?一個男孩一個女孩。我叫了他們一聲:馬軍!白鴿!那個男孩就是馬軍。</s>	joy	joy
<s> 前天在賓館吃飯的時候,不是有兩個孩子最後進來的嗎?一個男孩一個女孩。我叫了他們一聲:馬軍!白鴿!那個男孩就是馬軍。 </s></s> 那個男孩?</s>	surprise	surprise
<s></s></s> 對,那個男孩,他就是馬軍。</s>	joy	joy
<s> 對,那個男孩,他就是馬軍。 </s></s> 沒錯!我一看他就像韓東!</s>	joy	joy
<s></s></s> 噢,我當時也愣了一下,看他有點像一個人,也沒仔細看。</s>	surprise	surprise
<s> 噢,我當時也愣了一下,看他有點像一個人,也沒仔細看。 </s></s> 就是像東子唄!</s>	joy	joy
<s></s></s> 你們爲什麼事先不告訴我,他就是我的孩子?</s>	surprise	fear
<s> 你們爲什麼事先不告訴我,他就是我的孩子? </s></s> 我們也是剛知道,那天吃完了飯回去才知道的。</s>	neutral	neutral
<s></s></s> 你們怎麼知道的?</s>	surprise	surprise
<s> 你們怎麼知道的? </s></s> 馬軍的朋友白鴿,她爸是林業局的領導。她回去一問,她爸就說了,說馬軍就是他媽從醫院的長椅子上抱回去的孩子。這事林業局老一輩的人都知道,就是沒人知道是誰扔下的孩子。</s>	neutral	neutral
<s></s></s> 這回多虧三叔說出來了,要不還是沒人知道,那是咱們家的孩子。</s>	joy	joy
<s> 這回多虧三叔說出來了,要不還是沒人知道,那是咱們家的孩子。 </s></s> 真是巧事呀!</s>	joy	joy
<s></s></s> 應該感謝我大爺。大爺不回來,我爸還不會把這事說出來。</s>	joy	joy
<s> 應該感謝我大爺。大爺不回來,我爸還不會把這事說出來。 </s></s> 這回可好了,啥時候叫他回來吧?</s>	joy	joy
<s></s></s> 叫他回來可不那麼容易。</s>	fear	fear
<s> 叫他回來可不那麼容易。 </s></s> 他不願意回來?</s>	surprise	surprise
<s></s></s> 他願不願意回來是一回事,人家他爸他媽會不會放他回來還是個問題呢。</s>	fear	fear
<s> 他願不願意回來是一回事,人家他爸他媽會不會放他回來還是個問題呢。 </s></s> 你們知道他爸他媽是誰嗎?</s>	angry	surprise
<s></s></s> 我不是說了嗎?他爸是馬經理,他媽是誰不知道,他爺爺是馬廠長。我大爺也認識,是以前加工廠的老廠長。</s>	surprise	neutral
<s> 我不是說了嗎?他爸是馬經理,他媽是誰不知道,他爺爺是馬廠長。我大爺也認識,是以前加工廠的老廠長。 </s></s> 你認識?</s>	surprise	surprise
<s></s></s> 認識。我回來找你們之前,第一個找的人就是他。</s>	neutral	neutral
<s> 認識。我回來找你們之前,第一個找的人就是他。 </s></s> 他爸是誰?</s>	surprise	surprise
<s></s></s> 他爸是馬廠長的兒子,馬經理。</s>	neutral	neutral
<s> 他爸是馬廠長的兒子,馬經理。 </s></s> 我怎麼沒見過?</s>	surprise	surprise
<s></s></s> 您見過。那天吃飯的時候,馬軍和白鴿進來之後他才進來。他一進來就跟大夥喝酒。您一看見他,站起來就走了,我爸和我們也都走了。</s>	joy	neutral
<s> 您見過。那天吃飯的時候,馬軍和白鴿進來之後他才進來。他一進來就跟大夥喝酒。您一看見他,站起來就走了,我爸和我們也都走了。 </s></s> 是他?</s>	surprise	surprise
<s></s></s> 對,就是他。</s>	neutral	neutral
<s> 對,就是他。 </s></s> 怎麼會是他?你們沒弄錯吧?</s>	fear	surprise
<s></s></s> 您不是都看見孩子了嗎?那孩子還會錯嗎?</s>	fear	disgust
<s> 您不是都看見孩子了嗎?那孩子還會錯嗎? </s></s> 他們說,那天他爺爺在醫院住院,他媽媽早晨去照顧爺爺,看見椅子上有個孩子哭,她喊了幾聲沒人答應,知道是被人扔下的就抱回來了。要不是她把馬軍抱回去養活了,馬軍也就沒有了。看來咱們兩家還是有點緣分呢。</s>	joy	joy
<s></s></s> 真是有點巧。你跟那個馬軍熟嗎?以前認識嗎?</s>	surprise	surprise
<s> 真是有點巧。你跟那個馬軍熟嗎?以前認識嗎? </s></s> 我們太熟了,我們倆還是好朋友呢。</s>	joy	joy
<s></s></s> 他爸是那樣的人,你怎麼還跟他交朋友?</s>	surprise	surprise
<s> 他爸是那樣的人,你怎麼還跟他交朋友? </s></s> 那都是以前的事了,跟我們有什麼關係?再說,那時候是文化大革命,人都那樣。現在的人不是都變好了嗎?</s>	surprise	disgust
<s></s></s> 那天也沒好好看看那個孩子。</s>	sadness	sadness
<s> 那天也沒好好看看那個孩子。 </s></s> 這好辦,等我把他叫來,讓您好好看看。</s>	neutral	joy
<s></s></s> 唉,那時候你敢嗎?我是真怕呀,就怕留下他,連東子都保不住。你沒看見他們對東子多兇嗎?</s>	fear	sadness
<s> 唉,那時候你敢嗎?我是真怕呀,就怕留下他,連東子都保不住。你沒看見他們對東子多兇嗎? </s></s> 多虧了我沒扔到山上去,要不你連見都見不着了。</s>	fear	angry
<s></s></s> 韓東,你到這裏來一下,我跟你說件事。</s>	neutral	neutral
<s> 韓東,你到這裏來一下,我跟你說件事。 </s></s> 好吧,您先走,我把車停好。</s>	neutral	neutral
<s></s></s> 我來已經好幾天了,該回去了,再說,美玉還得上學,我也有點累了。這次來,看見順子她們過得挺好,還有韓東這麼個大兒子,我也放心了。不過我還是想幫他們一把,也應該幫一幫。我一時也想不出什麼辦法,能幫什麼忙。最簡單的事就是給他們留點錢吧,他們用得着。因爲過境有限制,不能多帶,我只能先給他們留下這些。</s>	neutral	sadness
<s> 我來已經好幾天了,該回去了,再說,美玉還得上學,我也有點累了。這次來,看見順子她們過得挺好,還有韓東這麼個大兒子,我也放心了。不過我還是想幫他們一把,也應該幫一幫。我一時也想不出什麼辦法,能幫什麼忙。最簡單的事就是給他們留點錢吧,他們用得着。因爲過境有限制,不能多帶,我只能先給他們留下這些。 </s></s> 這是兩萬塊錢人民幣,給你爸媽他們補貼一點生活。</s>	neutral	joy
<s> 我來已經好幾天了,該回去了,再說,美玉還得上學,我也有點累了。這次來,看見順子她們過得挺好,還有韓東這麼個大兒子,我也放心了。不過我還是想幫他們一把,也應該幫一幫。我一時也想不出什麼辦法,能幫什麼忙。最簡單的事就是給他們留點錢吧,他們用得着。因爲過境有限制,不能多帶,我只能先給他們留下這些。 這是兩萬塊錢人民幣,給你爸媽他們補貼一點生活。 </s></s> 不用了,大爺,我們挺好,也沒啥困難。</s>	joy	joy
<s> 我來已經好幾天了,該回去了,再說,美玉還得上學,我也有點累了。這次來,看見順子她們過得挺好,還有韓東這麼個大兒子,我也放心了。不過我還是想幫他們一把,也應該幫一幫。我一時也想不出什麼辦法,能幫什麼忙。最簡單的事就是給他們留點錢吧,他們用得着。因爲過境有限制,不能多帶,我只能先給他們留下這些。 這是兩萬塊錢人民幣,給你爸媽他們補貼一點生活。 不用了,大爺,我們挺好,也沒啥困難。 </s></s> 你們再好也沒有我們好啊。你爸媽身體都不好,就你一個人掙錢。他們年紀大了,也該好好保養一下身體了。拿着吧。</s>	neutral	joy
<s></s></s> 謝謝大爺!</s>	joy	joy
<s> 謝謝大爺! </s></s> 這錢你們先花着,回去以後我再想辦法匯過來一些。</s>	joy	joy
<s> 謝謝大爺! 這錢你們先花着,回去以後我再想辦法匯過來一些。 </s></s> 謝謝大爺!這麼多錢,我爸媽他們一時也花不完。</s>	joy	joy
<s> 謝謝大爺! 這錢你們先花着,回去以後我再想辦法匯過來一些。 謝謝大爺!這麼多錢,我爸媽他們一時也花不完。 </s></s> 他們也不知道怎麼花。你就先給他們拿着,用得着的時候再給他們。</s>	joy	joy
<s> 謝謝大爺! 這錢你們先花着,回去以後我再想辦法匯過來一些。 謝謝大爺!這麼多錢,我爸媽他們一時也花不完。 他們也不知道怎麼花。你就先給他們拿着,用得着的時候再給他們。 </s></s> 我想先給他們拾掇拾掇房子,那房子太破舊了,也太小了。</s>	neutral	joy
<s> 謝謝大爺! 這錢你們先花着,回去以後我再想辦法匯過來一些。 謝謝大爺!這麼多錢,我爸媽他們一時也花不完。 他們也不知道怎麼花。你就先給他們拿着,用得着的時候再給他們。 我想先給他們拾掇拾掇房子,那房子太破舊了,也太小了。 </s></s> 對對,先把房子拾掇一下,以後再陸續給他們添補些東西。</s>	joy	joy
<s> 謝謝大爺! 這錢你們先花着,回去以後我再想辦法匯過來一些。 謝謝大爺!這麼多錢,我爸媽他們一時也花不完。 他們也不知道怎麼花。你就先給他們拿着,用得着的時候再給他們。 我想先給他們拾掇拾掇房子,那房子太破舊了,也太小了。 對對,先把房子拾掇一下,以後再陸續給他們添補些東西。 </s></s> 以前我就想過,讓我媽辦一個幼兒園。我媽特別喜歡孩子,就讓她看看孩子,這樣她有事情做了,心情也能好一些。有了這些錢,這事就能辦了。她一定特別願意。</s>	joy	joy
<s> 謝謝大爺! 這錢你們先花着,回去以後我再想辦法匯過來一些。 謝謝大爺!這麼多錢,我爸媽他們一時也花不完。 他們也不知道怎麼花。你就先給他們拿着,用得着的時候再給他們。 我想先給他們拾掇拾掇房子,那房子太破舊了,也太小了。 對對,先把房子拾掇一下,以後再陸續給他們添補些東西。 以前我就想過,讓我媽辦一個幼兒園。我媽特別喜歡孩子,就讓她看看孩子,這樣她有事情做了,心情也能好一些。有了這些錢,這事就能辦了。她一定特別願意。 </s></s> 這也是個好主意。這樣一來她的晚年生活可就豐富了。能辦起來嗎?她願意做嗎?</s>	joy	surprise
<s> 謝謝大爺! 這錢你們先花着,回去以後我再想辦法匯過來一些。 謝謝大爺!這麼多錢,我爸媽他們一時也花不完。 他們也不知道怎麼花。你就先給他們拿着,用得着的時候再給他們。 我想先給他們拾掇拾掇房子,那房子太破舊了,也太小了。 對對,先把房子拾掇一下,以後再陸續給他們添補些東西。 以前我就想過,讓我媽辦一個幼兒園。我媽特別喜歡孩子,就讓她看看孩子,這樣她有事情做了,心情也能好一些。有了這些錢,這事就能辦了。她一定特別願意。 這也是個好主意。這樣一來她的晚年生活可就豐富了。能辦起來嗎?她願意做嗎? </s></s> 能!有這麼多錢,現蓋一座房子都夠了。</s>	joy	joy
<s> 謝謝大爺! 這錢你們先花着,回去以後我再想辦法匯過來一些。 謝謝大爺!這麼多錢,我爸媽他們一時也花不完。 他們也不知道怎麼花。你就先給他們拿着,用得着的時候再給他們。 我想先給他們拾掇拾掇房子,那房子太破舊了,也太小了。 對對,先把房子拾掇一下,以後再陸續給他們添補些東西。 以前我就想過,讓我媽辦一個幼兒園。我媽特別喜歡孩子,就讓她看看孩子,這樣她有事情做了,心情也能好一些。有了這些錢,這事就能辦了。她一定特別願意。 這也是個好主意。這樣一來她的晚年生活可就豐富了。能辦起來嗎?她願意做嗎? 能!有這麼多錢,現蓋一座房子都夠了。 </s></s> 那太好了!我回去以後儘快再匯一點錢來,你就幫她辦起來吧。</s>	joy	joy
<s> 謝謝大爺! 這錢你們先花着,回去以後我再想辦法匯過來一些。 謝謝大爺!這麼多錢,我爸媽他們一時也花不完。 他們也不知道怎麼花。你就先給他們拿着,用得着的時候再給他們。 我想先給他們拾掇拾掇房子,那房子太破舊了,也太小了。 對對,先把房子拾掇一下,以後再陸續給他們添補些東西。 以前我就想過,讓我媽辦一個幼兒園。我媽特別喜歡孩子,就讓她看看孩子,這樣她有事情做了,心情也能好一些。有了這些錢,這事就能辦了。她一定特別願意。 這也是個好主意。這樣一來她的晚年生活可就豐富了。能辦起來嗎?她願意做嗎? 能!有這麼多錢,現蓋一座房子都夠了。 那太好了!我回去以後儘快再匯一點錢來,你就幫她辦起來吧。 </s></s> 不用再匯了,這些錢就足夠了。</s>	joy	joy
<s> 這錢你們先花着,回去以後我再想辦法匯過來一些。 謝謝大爺!這麼多錢,我爸媽他們一時也花不完。 他們也不知道怎麼花。你就先給他們拿着,用得着的時候再給他們。 我想先給他們拾掇拾掇房子,那房子太破舊了,也太小了。 對對,先把房子拾掇一下,以後再陸續給他們添補些東西。 以前我就想過,讓我媽辦一個幼兒園。我媽特別喜歡孩子,就讓她看看孩子,這樣她有事情做了,心情也能好一些。有了這些錢,這事就能辦了。她一定特別願意。 這也是個好主意。這樣一來她的晚年生活可就豐富了。能辦起來嗎?她願意做嗎? 能!有這麼多錢,現蓋一座房子都夠了。 那太好了!我回去以後儘快再匯一點錢來,你就幫她辦起來吧。 不用再匯了,這些錢就足夠了。 </s></s> 好好好,這我就更放心了。</s>	joy	joy
<s> 謝謝大爺!這麼多錢,我爸媽他們一時也花不完。 他們也不知道怎麼花。你就先給他們拿着,用得着的時候再給他們。 我想先給他們拾掇拾掇房子,那房子太破舊了,也太小了。 對對,先把房子拾掇一下,以後再陸續給他們添補些東西。 以前我就想過,讓我媽辦一個幼兒園。我媽特別喜歡孩子,就讓她看看孩子,這樣她有事情做了,心情也能好一些。有了這些錢,這事就能辦了。她一定特別願意。 這也是個好主意。這樣一來她的晚年生活可就豐富了。能辦起來嗎?她願意做嗎? 能!有這麼多錢,現蓋一座房子都夠了。 那太好了!我回去以後儘快再匯一點錢來,你就幫她辦起來吧。 不用再匯了,這些錢就足夠了。 好好好,這我就更放心了。 </s></s> 大爺您不缺什麼東西嗎?</s>	neutral	surprise
<s> 他們也不知道怎麼花。你就先給他們拿着,用得着的時候再給他們。 我想先給他們拾掇拾掇房子,那房子太破舊了,也太小了。 對對,先把房子拾掇一下,以後再陸續給他們添補些東西。 以前我就想過,讓我媽辦一個幼兒園。我媽特別喜歡孩子,就讓她看看孩子,這樣她有事情做了,心情也能好一些。有了這些錢,這事就能辦了。她一定特別願意。 這也是個好主意。這樣一來她的晚年生活可就豐富了。能辦起來嗎?她願意做嗎? 能!有這麼多錢,現蓋一座房子都夠了。 那太好了!我回去以後儘快再匯一點錢來,你就幫她辦起來吧。 不用再匯了,這些錢就足夠了。 好好好,這我就更放心了。 大爺您不缺什麼東西嗎? </s></s> 我什麼都不缺。</s>	neutral	joy
<s> 我想先給他們拾掇拾掇房子,那房子太破舊了,也太小了。 對對,先把房子拾掇一下,以後再陸續給他們添補些東西。 以前我就想過,讓我媽辦一個幼兒園。我媽特別喜歡孩子,就讓她看看孩子,這樣她有事情做了,心情也能好一些。有了這些錢,這事就能辦了。她一定特別願意。 這也是個好主意。這樣一來她的晚年生活可就豐富了。能辦起來嗎?她願意做嗎? 能!有這麼多錢,現蓋一座房子都夠了。 那太好了!我回去以後儘快再匯一點錢來,你就幫她辦起來吧。 不用再匯了,這些錢就足夠了。 好好好,這我就更放心了。 大爺您不缺什麼東西嗎? 我什麼都不缺。 </s></s> 回去的車票買了嗎?</s>	neutral	surprise
<s> 對對,先把房子拾掇一下,以後再陸續給他們添補些東西。 以前我就想過,讓我媽辦一個幼兒園。我媽特別喜歡孩子,就讓她看看孩子,這樣她有事情做了,心情也能好一些。有了這些錢,這事就能辦了。她一定特別願意。 這也是個好主意。這樣一來她的晚年生活可就豐富了。能辦起來嗎?她願意做嗎? 能!有這麼多錢,現蓋一座房子都夠了。 那太好了!我回去以後儘快再匯一點錢來,你就幫她辦起來吧。 不用再匯了,這些錢就足夠了。 好好好,這我就更放心了。 大爺您不缺什麼東西嗎? 我什麼都不缺。 回去的車票買了嗎? </s></s> 我們坐飛機回去,在哈爾濱上飛機,車票買到哈爾濱就行。</s>	joy	neutral
<s> 以前我就想過,讓我媽辦一個幼兒園。我媽特別喜歡孩子,就讓她看看孩子,這樣她有事情做了,心情也能好一些。有了這些錢,這事就能辦了。她一定特別願意。 這也是個好主意。這樣一來她的晚年生活可就豐富了。能辦起來嗎?她願意做嗎? 能!有這麼多錢,現蓋一座房子都夠了。 那太好了!我回去以後儘快再匯一點錢來,你就幫她辦起來吧。 不用再匯了,這些錢就足夠了。 好好好,這我就更放心了。 大爺您不缺什麼東西嗎? 我什麼都不缺。 回去的車票買了嗎? 我們坐飛機回去,在哈爾濱上飛機,車票買到哈爾濱就行。 </s></s> 走的時候我給您買車票。我先回去了,您休息吧。</s>	neutral	joy
<s> 這也是個好主意。這樣一來她的晚年生活可就豐富了。能辦起來嗎?她願意做嗎? 能!有這麼多錢,現蓋一座房子都夠了。 那太好了!我回去以後儘快再匯一點錢來,你就幫她辦起來吧。 不用再匯了,這些錢就足夠了。 好好好,這我就更放心了。 大爺您不缺什麼東西嗎? 我什麼都不缺。 回去的車票買了嗎? 我們坐飛機回去,在哈爾濱上飛機,車票買到哈爾濱就行。 走的時候我給您買車票。我先回去了,您休息吧。 </s></s> 好吧。美玉送送你東哥。</s>	joy	joy
<s> 能!有這麼多錢,現蓋一座房子都夠了。 那太好了!我回去以後儘快再匯一點錢來,你就幫她辦起來吧。 不用再匯了,這些錢就足夠了。 好好好,這我就更放心了。 大爺您不缺什麼東西嗎? 我什麼都不缺。 回去的車票買了嗎? 我們坐飛機回去,在哈爾濱上飛機,車票買到哈爾濱就行。 走的時候我給您買車票。我先回去了,您休息吧。 好吧。美玉送送你東哥。 </s></s> 東哥,走吧。</s>	neutral	joy
<s></s></s> “國慶節前,印刷廠的</s>	neutral	neutral
<s> “國慶節前,印刷廠的 </s></s> “是這樣的。</s>	neutral	neutral
<s></s></s> 不是這家公司的產品,爲什麼要開他們的發票?</s>	surprise	surprise
<s> 不是這家公司的產品,爲什麼要開他們的發票? </s></s> 前進印刷廠的苗廠長說是要用這個公司的牌子。</s>	neutral	neutral
<s> 不是這家公司的產品,爲什麼要開他們的發票? 前進印刷廠的苗廠長說是要用這個公司的牌子。 </s></s> 是要用他們機器的牌子,還是用他們公司的牌子?</s>	surprise	surprise
<s> 不是這家公司的產品,爲什麼要開他們的發票? 前進印刷廠的苗廠長說是要用這個公司的牌子。 是要用他們機器的牌子,還是用他們公司的牌子? </s></s> 機器也不是他們生產的,是要用他們公司的牌子。</s>	neutral	neutral
<s> 不是這家公司的產品,爲什麼要開他們的發票? 前進印刷廠的苗廠長說是要用這個公司的牌子。 是要用他們機器的牌子,還是用他們公司的牌子? 機器也不是他們生產的,是要用他們公司的牌子。 </s></s> “既然不是他們生產的,用</s>	neutral	surprise
<s></s></s> 也許公司的名氣大一些?</s>	neutral	surprise
<s> 也許公司的名氣大一些? </s></s> 你覺得這裏面有什麼問題?</s>	neutral	angry
<s> 也許公司的名氣大一些? 你覺得這裏面有什麼問題? </s></s> 機器是從哈爾濱前進印刷廠買的,可發票用的是哈爾濱印刷器材公司的,而且錢也是讓我們匯給哈爾濱印刷器材公司,他們再由哈爾濱印刷器材公司轉哈爾濱前進印刷廠。這種作法不合常規,是不是和機器的質量有關係?據來幫助安裝的技師說,這兩臺印刷機都不是新的,都是他們廠的淘汰設備。</s>	neutral	fear
<s> 也許公司的名氣大一些? 你覺得這裏面有什麼問題? 機器是從哈爾濱前進印刷廠買的,可發票用的是哈爾濱印刷器材公司的,而且錢也是讓我們匯給哈爾濱印刷器材公司,他們再由哈爾濱印刷器材公司轉哈爾濱前進印刷廠。這種作法不合常規,是不是和機器的質量有關係?據來幫助安裝的技師說,這兩臺印刷機都不是新的,都是他們廠的淘汰設備。 </s></s> 那就是說,花了新機器的錢,買的是淘汰的設備?</s>	surprise	angry
<s> 也許公司的名氣大一些? 你覺得這裏面有什麼問題? 機器是從哈爾濱前進印刷廠買的,可發票用的是哈爾濱印刷器材公司的,而且錢也是讓我們匯給哈爾濱印刷器材公司,他們再由哈爾濱印刷器材公司轉哈爾濱前進印刷廠。這種作法不合常規,是不是和機器的質量有關係?據來幫助安裝的技師說,這兩臺印刷機都不是新的,都是他們廠的淘汰設備。 那就是說,花了新機器的錢,買的是淘汰的設備? </s></s> 事實就是這樣。</s>	neutral	disgust
<s> 也許公司的名氣大一些? 你覺得這裏面有什麼問題? 機器是從哈爾濱前進印刷廠買的,可發票用的是哈爾濱印刷器材公司的,而且錢也是讓我們匯給哈爾濱印刷器材公司,他們再由哈爾濱印刷器材公司轉哈爾濱前進印刷廠。這種作法不合常規,是不是和機器的質量有關係?據來幫助安裝的技師說,這兩臺印刷機都不是新的,都是他們廠的淘汰設備。 那就是說,花了新機器的錢,買的是淘汰的設備? 事實就是這樣。 </s></s> “</s>	neutral	angry
<s></s></s> 他們說,不是新的不等於就是淘汰的。這個價錢只能買這樣的機器。</s>	neutral	neutral
<s> 他們說,不是新的不等於就是淘汰的。這個價錢只能買這樣的機器。 </s></s> 姜科長,局裏經費一直很緊張,你們怎麼又想起買印刷機了呢?</s>	surprise	disgust
<s> 他們說,不是新的不等於就是淘汰的。這個價錢只能買這樣的機器。 姜科長,局裏經費一直很緊張,你們怎麼又想起買印刷機了呢? </s></s> “</s>	neutral	fear
<s></s></s> 問題是咱們的報紙可能要停發了。報紙停發,印刷廠就沒事幹,機構都可能精減下去,那還用買印刷機嗎?現有的設備不是也能應付眼前這點事嗎?</s>	fear	angry
<s> 問題是咱們的報紙可能要停發了。報紙停發,印刷廠就沒事幹,機構都可能精減下去,那還用買印刷機嗎?現有的設備不是也能應付眼前這點事嗎? </s></s> 我們考慮,咱們沒有套印設備,都是單色印刷,要出個套色的國慶專刊都不行。</s>	sadness	fear
<s> 問題是咱們的報紙可能要停發了。報紙停發,印刷廠就沒事幹,機構都可能精減下去,那還用買印刷機嗎?現有的設備不是也能應付眼前這點事嗎? 我們考慮,咱們沒有套印設備,都是單色印刷,要出個套色的國慶專刊都不行。 </s></s> 過了節呢?還要出套色的報紙嗎?</s>	surprise	surprise
<s> 問題是咱們的報紙可能要停發了。報紙停發,印刷廠就沒事幹,機構都可能精減下去,那還用買印刷機嗎?現有的設備不是也能應付眼前這點事嗎? 我們考慮,咱們沒有套印設備,都是單色印刷,要出個套色的國慶專刊都不行。 過了節呢?還要出套色的報紙嗎? </s></s> 咱們可以印廣告創收嘛。再說,咱們的報紙也不一定停。</s>	joy	fear
<s> 問題是咱們的報紙可能要停發了。報紙停發,印刷廠就沒事幹,機構都可能精減下去,那還用買印刷機嗎?現有的設備不是也能應付眼前這點事嗎? 我們考慮,咱們沒有套印設備,都是單色印刷,要出個套色的國慶專刊都不行。 過了節呢?還要出套色的報紙嗎? 咱們可以印廣告創收嘛。再說,咱們的報紙也不一定停。 </s></s> 買機器剩餘的錢還了嗎?</s>	surprise	neutral
<s> 問題是咱們的報紙可能要停發了。報紙停發,印刷廠就沒事幹,機構都可能精減下去,那還用買印刷機嗎?現有的設備不是也能應付眼前這點事嗎? 我們考慮,咱們沒有套印設備,都是單色印刷,要出個套色的國慶專刊都不行。 過了節呢?還要出套色的報紙嗎? 咱們可以印廣告創收嘛。再說,咱們的報紙也不一定停。 買機器剩餘的錢還了嗎? </s></s> 我們催過他。他說可能還要買別的設備,年底前如果不買設備了就還錢。</s>	neutral	neutral
<s> 問題是咱們的報紙可能要停發了。報紙停發,印刷廠就沒事幹,機構都可能精減下去,那還用買印刷機嗎?現有的設備不是也能應付眼前這點事嗎? 我們考慮,咱們沒有套印設備,都是單色印刷,要出個套色的國慶專刊都不行。 過了節呢?還要出套色的報紙嗎? 咱們可以印廣告創收嘛。再說,咱們的報紙也不一定停。 買機器剩餘的錢還了嗎? 我們催過他。他說可能還要買別的設備,年底前如果不買設備了就還錢。 </s></s> 我也跟他說過,我們再沒什麼用錢的地方了,讓他把錢還了。</s>	neutral	neutral
<s> 問題是咱們的報紙可能要停發了。報紙停發,印刷廠就沒事幹,機構都可能精減下去,那還用買印刷機嗎?現有的設備不是也能應付眼前這點事嗎? 我們考慮,咱們沒有套印設備,都是單色印刷,要出個套色的國慶專刊都不行。 過了節呢?還要出套色的報紙嗎? 咱們可以印廣告創收嘛。再說,咱們的報紙也不一定停。 買機器剩餘的錢還了嗎? 我們催過他。他說可能還要買別的設備,年底前如果不買設備了就還錢。 我也跟他說過,我們再沒什麼用錢的地方了,讓他把錢還了。 </s></s> 馬軍已經辦了停薪留職。按規定,有欠款的是不能辦停薪留職的,要辦得先把欠款還清了再辦。這是我們的一個失誤。你們要催緊點,年底前一定把錢追回來。</s>	angry	angry
<s></s></s> 就這樣,你們去忙吧。</s>	neutral	neutral
<s> 就這樣,你們去忙吧。 </s></s> 爺爺!爸!媽!你們都在家?</s>	surprise	surprise
<s> 就這樣,你們去忙吧。 爺爺!爸!媽!你們都在家? </s></s> 你坐下。</s>	neutral	angry
<s></s></s> 你欠下了一筆公款?</s>	surprise	angry
<s> 你欠下了一筆公款? </s></s> 您怎麼知道?</s>	surprise	surprise
<s> 你欠下了一筆公款? 您怎麼知道? </s></s> 你做下的事情別人還能不知道?財務科吳科長找的我。我明白他的意思,他是在告狀。</s>	neutral	angry
<s></s></s> 我欠的款我還嘛,跟家里人說幹嘛?</s>	surprise	disgust
<s> 我欠的款我還嘛,跟家里人說幹嘛? </s></s> 問題是你沒還嘛!</s>	neutral	angry
<s></s></s> 我跟他說了,年底前一定還。</s>	neutral	disgust
<s> 我跟他說了,年底前一定還。 </s></s> 現在能還就現在還,爲啥非等到年底呢?</s>	surprise	angry
<s></s></s> 我是考慮年前可能還要買些東西,等把東西買完了一塊還。</s>	neutral	fear
<s> 我是考慮年前可能還要買些東西,等把東西買完了一塊還。 </s></s> 你都停薪留職了,下崗了,你還買什麼東西?宣傳科的姜科長也說了,他們什麼也不想買了,他也要你趕緊還錢呢!</s>	angry	angry
<s></s></s> 你是不是還不了了?你把錢挪用了?</s>	angry	angry
<s> 你是不是還不了了?你把錢挪用了? </s></s> 沒有。</s>	neutral	fear
<s> 你是不是還不了了?你把錢挪用了? 沒有。 </s></s> 你成立的那個公司沒用錢?</s>	surprise	surprise
<s></s></s> 我們那個公司不是您給的錢嗎?</s>	surprise	neutral
<s> 我們那個公司不是您給的錢嗎? </s></s> 那你剩下的錢在哪兒呢?</s>	surprise	angry
<s></s></s> 在哈爾濱呢。</s>	neutral	neutral
<s> 在哈爾濱呢。 </s></s> 在哈爾濱什麼地方?什麼單位?</s>	surprise	angry
<s></s></s> 在哈爾濱前進印刷廠,就是我們買印刷機的那個單位。</s>	neutral	neutral
<s> 在哈爾濱前進印刷廠,就是我們買印刷機的那個單位。 </s></s> 還剩下多少錢?</s>	neutral	surprise
<s></s></s> 十四萬。</s>	neutral	neutral
<s> 十四萬。 </s></s> “十四萬?這麼大一筆錢怎麼能存放在外邊?這顯然是不合適的。全局各單位資金都很緊張。你卻把這麼大一筆錢放在外邊不管,難怪人家財務科着急,而且也不安全。你能保證那錢不會被動用嗎?</s>	surprise	angry
<s></s></s> 你沒讓他給匯回來嘛!</s>	angry	angry
<s> 你沒讓他給匯回來嘛! </s></s> 我跟他說了,不知道他爲啥還沒給匯,我再催催他唄。</s>	angry	fear
<s> 你沒讓他給匯回來嘛! 我跟他說了,不知道他爲啥還沒給匯,我再催催他唄。 </s></s> 你趕緊催他。你的事局裏夠照顧你的了。按規定你有欠款就不能辦停薪留職,人家還是給你辦了。你得講點信用,給人家長臉。</s>	angry	angry
<s></s></s> 我知道,他們是看您的面子。</s>	angry	fear
<s> 我知道,他們是看您的面子。 </s></s> 知道就好,知道就別給我臉上抹黑。</s>	neutral	angry
<s> 我知道,他們是看您的面子。 知道就好,知道就別給我臉上抹黑。 </s></s> 行了,小軍你記着趕緊還錢。這件事就這樣吧。那個事兒怎麼辦呀?</s>	fear	fear
<s></s></s> 還有啥事兒?</s>	surprise	surprise
<s> 還有啥事兒? </s></s> 他們不是說你是他們的孩子嗎?</s>	angry	fear
<s></s></s> 誰們呀?</s>	surprise	surprise
<s> 誰們呀? </s></s> 韓長脖他們唄!</s>	joy	surprise
<s></s></s> 我是不是他們的孩子,你們還不知道嗎?</s>	angry	disgust
<s> 我是不是他們的孩子,你們還不知道嗎? </s></s> 我們知道,現在你也知道了。大家都知道了,問題是怎麼解決,下一步怎麼辦?</s>	fear	fear
<s></s></s> 有什麼下一步呀?</s>	surprise	disgust
<s> 有什麼下一步呀? </s></s> 他們沒說叫你回去嗎?</s>	surprise	fear
<s></s></s> 誰說叫我回去了?您覺得我應該回去嗎?</s>	surprise	surprise
<s> 誰說叫我回去了?您覺得我應該回去嗎? </s></s> 要我說你當然不應該回去了,世上沒有那個道理,扔了還有往回要的?</s>	angry	angry
<s></s></s> 那不得了,您還想那麼多幹啥?</s>	surprise	surprise
<s> 那不得了,您還想那麼多幹啥? </s></s> 關鍵不在我想不想,而是他們想不想。</s>	neutral	fear
<s> 那不得了,您還想那麼多幹啥? 關鍵不在我想不想,而是他們想不想。 </s></s> 出了這種事,要說他們不想也是不可能的。這一點咱們應該理解。</s>	fear	neutral
<s> 那不得了,您還想那麼多幹啥? 關鍵不在我想不想,而是他們想不想。 出了這種事,要說他們不想也是不可能的。這一點咱們應該理解。 </s></s> 事情已經清楚了,我相信他們能夠正確面對。</s>	neutral	joy
<s> 那不得了,您還想那麼多幹啥? 關鍵不在我想不想,而是他們想不想。 出了這種事,要說他們不想也是不可能的。這一點咱們應該理解。 事情已經清楚了,我相信他們能夠正確面對。 </s></s> 不光他們要正確面對,咱們也要正確面對。這件事說起來咱們也是有責任的。</s>	neutral	fear
<s> 那不得了,您還想那麼多幹啥? 關鍵不在我想不想,而是他們想不想。 出了這種事,要說他們不想也是不可能的。這一點咱們應該理解。 事情已經清楚了,我相信他們能夠正確面對。 不光他們要正確面對,咱們也要正確面對。這件事說起來咱們也是有責任的。 </s></s> 您是說我當初不該把孩子抱回來?</s>	surprise	surprise
<s> 那不得了,您還想那麼多幹啥? 關鍵不在我想不想,而是他們想不想。 出了這種事,要說他們不想也是不可能的。這一點咱們應該理解。 事情已經清楚了,我相信他們能夠正確面對。 不光他們要正確面對,咱們也要正確面對。這件事說起來咱們也是有責任的。 您是說我當初不該把孩子抱回來? </s></s> 我不是說你不該抱回來。你抱回來是對的。你要不抱回來,孩子就死在那了。我是說他們扔孩子,那是迫不得已。你想,誰生了孩子不稀罕,還願意把他扔了?</s>	angry	fear
<s> 那不得了,您還想那麼多幹啥? 關鍵不在我想不想,而是他們想不想。 出了這種事,要說他們不想也是不可能的。這一點咱們應該理解。 事情已經清楚了,我相信他們能夠正確面對。 不光他們要正確面對,咱們也要正確面對。這件事說起來咱們也是有責任的。 您是說我當初不該把孩子抱回來? 我不是說你不該抱回來。你抱回來是對的。你要不抱回來,孩子就死在那了。我是說他們扔孩子,那是迫不得已。你想,誰生了孩子不稀罕,還願意把他扔了? </s></s> 那是咱們叫他扔的?</s>	surprise	angry
<s> 那不得了,您還想那麼多幹啥? 關鍵不在我想不想,而是他們想不想。 出了這種事,要說他們不想也是不可能的。這一點咱們應該理解。 事情已經清楚了,我相信他們能夠正確面對。 不光他們要正確面對,咱們也要正確面對。這件事說起來咱們也是有責任的。 您是說我當初不該把孩子抱回來? 我不是說你不該抱回來。你抱回來是對的。你要不抱回來,孩子就死在那了。我是說他們扔孩子,那是迫不得已。你想,誰生了孩子不稀罕,還願意把他扔了? 那是咱們叫他扔的? </s></s> 老爸說得對。咱們是有責任的,這個責任就在我。我的行爲給他們造成了壓力,使得他們不敢留下這個孩子。</s>	neutral	sadness
<s> 那不得了,您還想那麼多幹啥? 關鍵不在我想不想,而是他們想不想。 出了這種事,要說他們不想也是不可能的。這一點咱們應該理解。 事情已經清楚了,我相信他們能夠正確面對。 不光他們要正確面對,咱們也要正確面對。這件事說起來咱們也是有責任的。 您是說我當初不該把孩子抱回來? 我不是說你不該抱回來。你抱回來是對的。你要不抱回來,孩子就死在那了。我是說他們扔孩子,那是迫不得已。你想,誰生了孩子不稀罕,還願意把他扔了? 那是咱們叫他扔的? 老爸說得對。咱們是有責任的,這個責任就在我。我的行爲給他們造成了壓力,使得他們不敢留下這個孩子。 </s></s> 那不是文化大革命嗎?造反的又不是你一個!你不去抓他別的人也會去。再說,你也沒動手打他。他要真給別的人抓去了,說不定更慘呢。</s>	angry	angry
<s> 那不得了,您還想那麼多幹啥? 關鍵不在我想不想,而是他們想不想。 出了這種事,要說他們不想也是不可能的。這一點咱們應該理解。 事情已經清楚了,我相信他們能夠正確面對。 不光他們要正確面對,咱們也要正確面對。這件事說起來咱們也是有責任的。 您是說我當初不該把孩子抱回來? 我不是說你不該抱回來。你抱回來是對的。你要不抱回來,孩子就死在那了。我是說他們扔孩子,那是迫不得已。你想,誰生了孩子不稀罕,還願意把他扔了? 那是咱們叫他扔的? 老爸說得對。咱們是有責任的,這個責任就在我。我的行爲給他們造成了壓力,使得他們不敢留下這個孩子。 那不是文化大革命嗎?造反的又不是你一個!你不去抓他別的人也會去。再說,你也沒動手打他。他要真給別的人抓去了,說不定更慘呢。 </s></s> “這種事誰去幹都是不對的。凡事都有個界限,</s>	angry	sadness
<s></s></s> 寶林說得對。</s>	neutral	neutral
<s> 寶林說得對。 </s></s> 爸也是,管那麼多事幹嘛!爺爺,您說,我爸是不是太愛管閒事了?</s>	sadness	disgust
<s> 寶林說得對。 爸也是,管那麼多事幹嘛!爺爺,您說,我爸是不是太愛管閒事了? </s></s> 不是你爸愛管閒事,那時候都那樣。我爲啥總挨批鬥?那時候講階級鬥爭,講革命,誰不鬥爭不革命也不行,還惟恐落了後呢。</s>	sadness	fear
<s></s></s> 不可理解。</s>	sadness	angry
<s> 不可理解。 </s></s> 以前的事也用不着你理解,你把現在的事理解了就行。人家也沒說要你跟他們。你想跟他們人家還不一定要呢。你先去看看人家再說。這是應該的。</s>	angry	neutral
<s> 不可理解。 以前的事也用不着你理解,你把現在的事理解了就行。人家也沒說要你跟他們。你想跟他們人家還不一定要呢。你先去看看人家再說。這是應該的。 </s></s> 我看,小軍就去他們家看看那兩個老人吧,那是你的親爸親媽,你要認下他們。</s>	neutral	sadness
<s></s></s> 怎麼,當初他們把我扔了,現在你們又要把我扔出去呀?</s>	surprise	angry
<s> 怎麼,當初他們把我扔了,現在你們又要把我扔出去呀? </s></s> 我可不想把你扔出去。你去看看他們可以,認個親爸親媽也行。可你還是我的兒子,是我把你養大的。我還指望你給我養老送終呢。</s>	sadness	sadness
<s></s></s> 那你們就成了我的乾爸乾媽了?</s>	surprise	surprise
<s> 那你們就成了我的乾爸乾媽了? </s></s> 乾爸乾媽也行。</s>	joy	neutral
<s></s></s> 人家是有親爸親媽再認個乾爸乾媽。我是先有乾爸乾媽再去認親爸親媽。</s>	neutral	disgust
<s> 人家是有親爸親媽再認個乾爸乾媽。我是先有乾爸乾媽再去認親爸親媽。 </s></s> 認乾爸乾媽不有的是嗎?兩家歸一家,歸根到底都還是一家人。</s>	surprise	neutral
<s></s></s> 我要是不想跟他們呢?</s>	angry	disgust
<s> 我要是不想跟他們呢? </s></s> 那不是你的親爸親媽嗎?</s>	surprise	surprise
<s></s></s> 親爸親媽爲啥還把我扔了?</s>	surprise	angry
<s> 親爸親媽爲啥還把我扔了? </s></s> 他們也是沒辦法。這種事我能理解。</s>	sadness	sadness
<s></s></s> 我看這事也沒那麼簡單。你們也別把事情看得太簡單了。他們扔了一個孩子,你們抱回來一個孩子。二十多年過去了,他們說那個孩子是他們的。你們說,行,還給你們,領回去吧。就這麼簡單嗎?這是人,不是物。物可以隨便送人,人可不行。人是有感情的,是有自己選擇的,是可以給自己作主的。還有,人也是有血緣關係的。血緣是改變不了的,該是誰家的人就是誰家的人,誰也改變不了這個事實。</s>	neutral	angry
<s> 我看這事也沒那麼簡單。你們也別把事情看得太簡單了。他們扔了一個孩子,你們抱回來一個孩子。二十多年過去了,他們說那個孩子是他們的。你們說,行,還給你們,領回去吧。就這麼簡單嗎?這是人,不是物。物可以隨便送人,人可不行。人是有感情的,是有自己選擇的,是可以給自己作主的。還有,人也是有血緣關係的。血緣是改變不了的,該是誰家的人就是誰家的人,誰也改變不了這個事實。 </s></s> 對!小軍說得對。</s>	joy	joy
<s> 我看這事也沒那麼簡單。你們也別把事情看得太簡單了。他們扔了一個孩子,你們抱回來一個孩子。二十多年過去了,他們說那個孩子是他們的。你們說,行,還給你們,領回去吧。就這麼簡單嗎?這是人,不是物。物可以隨便送人,人可不行。人是有感情的,是有自己選擇的,是可以給自己作主的。還有,人也是有血緣關係的。血緣是改變不了的,該是誰家的人就是誰家的人,誰也改變不了這個事實。 對!小軍說得對。 </s></s> 你不願意過去,這可以理解,也沒說馬上就讓你過去。</s>	neutral	sadness
<s></s></s> 現在還不是我願不願意的問題。這麼大的事,這麼長的時間了,一句話就說清楚了?這中間就不會有什麼出入?有什麼差錯?</s>	angry	angry
<s> 現在還不是我願不願意的問題。這麼大的事,這麼長的時間了,一句話就說清楚了?這中間就不會有什麼出入?有什麼差錯? </s></s> 我就說嘛!我抱回一個孩子不假。他說他扔過一個孩子,誰看見了?他爲啥要扔?扔在哪兒了?誰知道他那個孩子究竟是扔了還是讓人抱走了?是誰抱走了?怎麼他說了這麼一句話你們就相信了?他要是能給我證明馬軍就是他的孩子,行!我就給他!他能證明嗎?</s>	angry	angry
<s></s></s> 要證明我是誰家的人,光憑誰看見了,誰說什麼了不行,得有證據,現在唯一的證據就是血緣,作血緣鑑定。</s>	neutral	angry
<s> 要證明我是誰家的人,光憑誰看見了,誰說什麼了不行,得有證據,現在唯一的證據就是血緣,作血緣鑑定。 </s></s> 作親子鑑定?有必要嗎?</s>	surprise	surprise
<s></s></s> 我看有必要。</s>	neutral	angry
<s> 我看有必要。 </s></s> 有必要!太有必要了!鑑定以後證明馬軍是他們的孩子,我二話不說!</s>	joy	angry
<s> 我看有必要。 有必要!太有必要了!鑑定以後證明馬軍是他們的孩子,我二話不說! </s></s> 那可麻煩了。</s>	neutral	surprise
<s> 我看有必要。 有必要!太有必要了!鑑定以後證明馬軍是他們的孩子,我二話不說! 那可麻煩了。 </s></s> 不麻煩,咱們醫院就可以作。</s>	joy	neutral
<s> 我看有必要。 有必要!太有必要了!鑑定以後證明馬軍是他們的孩子,我二話不說! 那可麻煩了。 不麻煩,咱們醫院就可以作。 </s></s> 作親子鑑定得兩邊都作才行,他們願意嗎?</s>	joy	fear
<s> 我看有必要。 有必要!太有必要了!鑑定以後證明馬軍是他們的孩子,我二話不說! 那可麻煩了。 不麻煩,咱們醫院就可以作。 作親子鑑定得兩邊都作才行,他們願意嗎? </s></s> 他們應該願意,想要孩子你就得作。</s>	joy	angry
<s> 我看有必要。 有必要!太有必要了!鑑定以後證明馬軍是他們的孩子,我二話不說! 那可麻煩了。 不麻煩,咱們醫院就可以作。 作親子鑑定得兩邊都作才行,他們願意嗎? 他們應該願意,想要孩子你就得作。 </s></s> 這話怎麼跟人家說?</s>	surprise	fear
<s> 我看有必要。 有必要!太有必要了!鑑定以後證明馬軍是他們的孩子,我二話不說! 那可麻煩了。 不麻煩,咱們醫院就可以作。 作親子鑑定得兩邊都作才行,他們願意嗎? 他們應該願意,想要孩子你就得作。 這話怎麼跟人家說? </s></s> 這有啥不好說的?科學嘛。</s>	joy	neutral
<s></s></s> 我看你就是不想認這個親爸親媽,對不對?</s>	angry	angry
<s> 我看你就是不想認這個親爸親媽,對不對? </s></s> 我咋不想認?只要是我的親爸親媽,我爲啥不想認?</s>	surprise	disgust
<s> 我看你就是不想認這個親爸親媽,對不對? 我咋不想認?只要是我的親爸親媽,我爲啥不想認? </s></s> 你認了這個親爸親媽,你們就有了血緣關係,那你跟美玉就沒戲了,對不對?</s>	joy	angry
<s> 我看你就是不想認這個親爸親媽,對不對? 我咋不想認?只要是我的親爸親媽,我爲啥不想認? 你認了這個親爸親媽,你們就有了血緣關係,那你跟美玉就沒戲了,對不對? </s></s> 那我跟美玉就是親妹妹了,怎麼還沒戲了呢?</s>	sadness	surprise
<s> 我看你就是不想認這個親爸親媽,對不對? 我咋不想認?只要是我的親爸親媽,我爲啥不想認? 你認了這個親爸親媽,你們就有了血緣關係,那你跟美玉就沒戲了,對不對? 那我跟美玉就是親妹妹了,怎麼還沒戲了呢? </s></s> 是親妹妹就不可能是情人了,不可能是老婆了,不是嗎?</s>	surprise	angry
<s> 我看你就是不想認這個親爸親媽,對不對? 我咋不想認?只要是我的親爸親媽,我爲啥不想認? 你認了這個親爸親媽,你們就有了血緣關係,那你跟美玉就沒戲了,對不對? 那我跟美玉就是親妹妹了,怎麼還沒戲了呢? 是親妹妹就不可能是情人了,不可能是老婆了,不是嗎? </s></s> 我也沒想她成我的老婆呀?</s>	surprise	surprise
<s> 我看你就是不想認這個親爸親媽,對不對? 我咋不想認?只要是我的親爸親媽,我爲啥不想認? 你認了這個親爸親媽,你們就有了血緣關係,那你跟美玉就沒戲了,對不對? 那我跟美玉就是親妹妹了,怎麼還沒戲了呢? 是親妹妹就不可能是情人了,不可能是老婆了,不是嗎? 我也沒想她成我的老婆呀? </s></s> 沒想嗎?</s>	disgust	surprise
<s> 我看你就是不想認這個親爸親媽,對不對? 我咋不想認?只要是我的親爸親媽,我爲啥不想認? 你認了這個親爸親媽,你們就有了血緣關係,那你跟美玉就沒戲了,對不對? 那我跟美玉就是親妹妹了,怎麼還沒戲了呢? 是親妹妹就不可能是情人了,不可能是老婆了,不是嗎? 我也沒想她成我的老婆呀? 沒想嗎? </s></s> 沒想!</s>	angry	angry
<s> 我看你就是不想認這個親爸親媽,對不對? 我咋不想認?只要是我的親爸親媽,我爲啥不想認? 你認了這個親爸親媽,你們就有了血緣關係,那你跟美玉就沒戲了,對不對? 那我跟美玉就是親妹妹了,怎麼還沒戲了呢? 是親妹妹就不可能是情人了,不可能是老婆了,不是嗎? 我也沒想她成我的老婆呀? 沒想嗎? 沒想! </s></s> 想也沒關係,也正常。那麼漂亮的姑娘,哪個男人見了不喜歡呀?就怕他得不到!</s>	disgust	angry
<s> 我看你就是不想認這個親爸親媽,對不對? 我咋不想認?只要是我的親爸親媽,我爲啥不想認? 你認了這個親爸親媽,你們就有了血緣關係,那你跟美玉就沒戲了,對不對? 那我跟美玉就是親妹妹了,怎麼還沒戲了呢? 是親妹妹就不可能是情人了,不可能是老婆了,不是嗎? 我也沒想她成我的老婆呀? 沒想嗎? 沒想! 想也沒關係,也正常。那麼漂亮的姑娘,哪個男人見了不喜歡呀?就怕他得不到! </s></s> 所以呀,她成不了我的老婆還能成我的妹妹呢,這不也挺好嗎?</s>	joy	joy
<s> 我看你就是不想認這個親爸親媽,對不對? 我咋不想認?只要是我的親爸親媽,我爲啥不想認? 你認了這個親爸親媽,你們就有了血緣關係,那你跟美玉就沒戲了,對不對? 那我跟美玉就是親妹妹了,怎麼還沒戲了呢? 是親妹妹就不可能是情人了,不可能是老婆了,不是嗎? 我也沒想她成我的老婆呀? 沒想嗎? 沒想! 想也沒關係,也正常。那麼漂亮的姑娘,哪個男人見了不喜歡呀?就怕他得不到! 所以呀,她成不了我的老婆還能成我的妹妹呢,這不也挺好嗎? </s></s> “這麼漂亮的姑娘成不了自己的老婆未免可惜呀。</s>	sadness	surprise
<s> 我咋不想認?只要是我的親爸親媽,我爲啥不想認? 你認了這個親爸親媽,你們就有了血緣關係,那你跟美玉就沒戲了,對不對? 那我跟美玉就是親妹妹了,怎麼還沒戲了呢? 是親妹妹就不可能是情人了,不可能是老婆了,不是嗎? 我也沒想她成我的老婆呀? 沒想嗎? 沒想! 想也沒關係,也正常。那麼漂亮的姑娘,哪個男人見了不喜歡呀?就怕他得不到! 所以呀,她成不了我的老婆還能成我的妹妹呢,這不也挺好嗎? “這麼漂亮的姑娘成不了自己的老婆未免可惜呀。 </s></s> 我的未婚老婆就是個挺漂亮的姑娘,我還有什麼可惜的?要是這個未婚老婆如果成不了我的真老婆那才叫可惜呢。</s>	sadness	joy
<s> 你認了這個親爸親媽,你們就有了血緣關係,那你跟美玉就沒戲了,對不對? 那我跟美玉就是親妹妹了,怎麼還沒戲了呢? 是親妹妹就不可能是情人了,不可能是老婆了,不是嗎? 我也沒想她成我的老婆呀? 沒想嗎? 沒想! 想也沒關係,也正常。那麼漂亮的姑娘,哪個男人見了不喜歡呀?就怕他得不到! 所以呀,她成不了我的老婆還能成我的妹妹呢,這不也挺好嗎? “這麼漂亮的姑娘成不了自己的老婆未免可惜呀。 我的未婚老婆就是個挺漂亮的姑娘,我還有什麼可惜的?要是這個未婚老婆如果成不了我的真老婆那才叫可惜呢。 </s></s> 誰是你的未婚老婆?</s>	surprise	surprise
<s> 那我跟美玉就是親妹妹了,怎麼還沒戲了呢? 是親妹妹就不可能是情人了,不可能是老婆了,不是嗎? 我也沒想她成我的老婆呀? 沒想嗎? 沒想! 想也沒關係,也正常。那麼漂亮的姑娘,哪個男人見了不喜歡呀?就怕他得不到! 所以呀,她成不了我的老婆還能成我的妹妹呢,這不也挺好嗎? “這麼漂亮的姑娘成不了自己的老婆未免可惜呀。 我的未婚老婆就是個挺漂亮的姑娘,我還有什麼可惜的?要是這個未婚老婆如果成不了我的真老婆那才叫可惜呢。 誰是你的未婚老婆? </s></s> 這不是明知故問嗎?她正在跟我商量怎麼才能成爲我的已婚老婆呢。</s>	neutral	joy
<s> 是親妹妹就不可能是情人了,不可能是老婆了,不是嗎? 我也沒想她成我的老婆呀? 沒想嗎? 沒想! 想也沒關係,也正常。那麼漂亮的姑娘,哪個男人見了不喜歡呀?就怕他得不到! 所以呀,她成不了我的老婆還能成我的妹妹呢,這不也挺好嗎? “這麼漂亮的姑娘成不了自己的老婆未免可惜呀。 我的未婚老婆就是個挺漂亮的姑娘,我還有什麼可惜的?要是這個未婚老婆如果成不了我的真老婆那才叫可惜呢。 誰是你的未婚老婆? 這不是明知故問嗎?她正在跟我商量怎麼才能成爲我的已婚老婆呢。 </s></s> 作夢吧你!</s>	joy	angry
<s></s></s> 案子?什麼案子?</s>	surprise	surprise
<s> 案子?什麼案子? </s></s> 是這樣的。我是哈爾濱市道外區公安分局的。你知道哈爾濱市前進印刷廠嗎?</s>	neutral	neutral